Código,Município,Código TI,Território de Identidade,QtMédicosSUS,QtMédicosNãoSUS,QtEnfermeirosSUS,QtEnfermeirosNãoSUS,QtProfissionais
2900108,Abaíra,3,Chapada Diamantina,4,0,7,0,11
2900207,Abaré,24,Itaparica,9,0,19,0,28
2900306,Acajutiba,18,Litoral Norte e Agreste Baiano,9,2,12,0,23
2900355,Adustina,17,Semiárido Nordeste II,7,0,9,1,17
2900405,Água Fria,19,Portal do Sertão,8,0,15,0,23
2900504,Érico Cardoso,12,Bacia do Paramirim,6,0,13,0,19
2900603,Aiquara,22,Médio Rio de Contas,2,0,7,0,9
2900702,Alagoinhas,18,Litoral Norte e Agreste Baiano,171,121,179,24,495
2900801,Alcobaça,7,Extremo Sul,21,0,20,0,41
2900900,Almadina,5,Litoral Sul,5,0,5,0,10
2901007,Amargosa,9,Vale do Jiquiriçá,24,11,39,0,74
2901106,Amélia Rodrigues,19,Portal do Sertão,18,1,18,0,37
2901155,América Dourada,1,Irecê,15,0,20,0,35
2901205,Anagé,20,Sudoeste Baiano,16,0,22,0,38
2901304,Andaraí,3,Chapada Diamantina,11,0,9,0,20
2901353,Andorinha,25,Piemonte Norte do Itapicuru,4,3,10,0,17
2901403,Angical,11,Bacia do Rio Grande,5,0,12,0,17
2901502,Anguera,19,Portal do Sertão,5,0,13,0,18
2901601,Antas,17,Semiárido Nordeste II,13,0,20,0,33
2901700,Antônio Cardoso,19,Portal do Sertão,4,0,11,0,15
2901809,Antônio Gonçalves,25,Piemonte Norte do Itapicuru,3,0,10,0,13
2901908,Aporá,18,Litoral Norte e Agreste Baiano,9,0,6,0,15
2901957,Apuarema,22,Médio Rio de Contas,5,0,7,0,12
2902005,Aracatu,20,Sudoeste Baiano,11,0,16,0,27
2902054,Araçás,18,Litoral Norte e Agreste Baiano,9,0,6,0,15
2902104,Araci,4,Sisal,20,2,42,0,64
2902203,Aramari,18,Litoral Norte e Agreste Baiano,2,0,6,0,8
2902252,Arataca,5,Litoral Sul,5,0,10,0,15
2902302,Aratuípe,6,Baixo Sul,3,0,9,0,12
2902401,Aurelino Leal,5,Litoral Sul,8,0,10,0,18
2902500,Baianópolis,11,Bacia do Rio Grande,6,0,14,0,20
2902609,Baixa Grande,15,Bacia do Jacuípe,9,0,11,0,20
2902658,Banzaê,17,Semiárido Nordeste II,5,0,13,0,18
2902708,Barra,2,Velho Chico,28,0,40,0,68
2902807,Barra da Estiva,3,Chapada Diamantina,14,2,22,0,38
2902906,Barra do Choça,20,Sudoeste Baiano,24,1,21,0,46
2903003,Barra do Mendes,1,Irecê,4,0,17,0,21
2903102,Barra do Rocha,22,Médio Rio de Contas,1,0,4,0,5
2903201,Barreiras,11,Bacia do Rio Grande,201,84,266,5,556
2903235,Barro Alto,1,Irecê,6,0,7,0,13
2903276,Barrocas,4,Sisal,7,0,13,1,21
2903300,Barro Preto,5,Litoral Sul,5,0,7,0,12
2903409,Belmonte,27,Costa do Descobrimento,16,0,22,0,38
2903508,Belo Campo,20,Sudoeste Baiano,12,0,20,0,32
2903607,Biritinga,4,Sisal,9,0,16,0,25
2903706,Boa Nova,22,Médio Rio de Contas,4,0,10,0,14
2903805,Boa Vista do Tupim,14,Piemonte do Paraguaçu,11,0,11,0,22
2903904,Bom Jesus da Lapa,2,Velho Chico,63,8,80,0,151
2903953,Bom Jesus da Serra,20,Sudoeste Baiano,9,0,11,0,20
2904001,Boninal,3,Chapada Diamantina,3,0,7,0,10
2904050,Bonito,3,Chapada Diamantina,8,0,10,0,18
2904100,Boquira,12,Bacia do Paramirim,7,0,20,0,27
2904209,Botuporã,12,Bacia do Paramirim,7,0,11,0,18
2904308,Brejões,9,Vale do Jiquiriçá,5,0,7,0,12
2904407,Brejolândia,23,Bacia do Rio Corrente,2,0,7,0,9
2904506,Brotas de Macaúbas,2,Velho Chico,6,0,8,0,14
2904605,Brumado,13,Sertão Produtivo,76,28,75,4,183
2904704,Buerarema,5,Litoral Sul,7,0,16,0,23
2904753,Buritirama,11,Bacia do Rio Grande,4,0,16,0,20
2904803,Caatiba,8,Médio Sudoeste da Bahia,3,0,6,0,9
2904852,Cabaceiras do Paraguaçu,21,Recôncavo,5,0,18,0,23
2904902,Cachoeira,21,Recôncavo,27,8,30,0,65
2905008,Caculé,13,Sertão Produtivo,11,19,22,1,53
2905107,Caém,16,Piemonte da Diamantina,9,0,7,0,16
2905156,Caetanos,20,Sudoeste Baiano,6,0,11,0,17
2905206,Caetité,13,Sertão Produtivo,54,11,41,2,108
2905305,Cafarnaum,1,Irecê,12,0,12,0,24
2905404,Cairu,6,Baixo Sul,11,0,11,0,22
2905503,Caldeirão Grande,25,Piemonte Norte do Itapicuru,6,0,8,0,14
2905602,Camacan,5,Litoral Sul,21,1,27,0,49
2905701,Camaçari,26,Metropolitano de Salvador,431,145,279,29,884
2905800,Camamu,6,Baixo Sul,15,6,26,0,47
2905909,Campo Alegre de Lourdes,10,Sertão do São Francisco,8,0,17,1,26
2906006,Campo Formoso,25,Piemonte Norte do Itapicuru,43,9,36,0,88
2906105,Canápolis,23,Bacia do Rio Corrente,5,0,8,0,13
2906204,Canarana,1,Irecê,12,0,16,0,28
2906303,Canavieiras,5,Litoral Sul,17,3,20,1,41
2906402,Candeal,4,Sisal,7,0,8,0,15
2906501,Candeias,26,Metropolitano de Salvador,88,35,76,19,218
2906600,Candiba,13,Sertão Produtivo,3,0,5,0,8
2906709,Cândido Sales,20,Sudoeste Baiano,8,0,21,0,29
2906808,Cansanção,4,Sisal,17,1,21,0,39
2906824,Canudos,10,Sertão do São Francisco,8,0,12,0,20
2906857,Capela do Alto Alegre,15,Bacia do Jacuípe,10,0,12,0,22
2906873,Capim Grosso,15,Bacia do Jacuípe,18,3,30,0,51
2906899,Caraíbas,20,Sudoeste Baiano,3,0,12,0,15
2906907,Caravelas,7,Extremo Sul,11,0,20,0,31
2907004,Cardeal da Silva,18,Litoral Norte e Agreste Baiano,6,0,4,0,10
2907103,Carinhanha,2,Velho Chico,15,3,17,0,35
2907202,Casa Nova,10,Sertão do São Francisco,35,1,27,0,63
2907301,Castro Alves,21,Recôncavo,16,2,29,0,47
2907400,Catolândia,11,Bacia do Rio Grande,1,0,4,0,5
2907509,Catu,18,Litoral Norte e Agreste Baiano,26,27,34,11,98
2907558,Caturama,12,Bacia do Paramirim,4,0,12,0,16
2907608,Central,1,Irecê,7,0,12,0,19
2907707,Chorrochó,24,Itaparica,5,0,15,0,20
2907806,Cícero Dantas,17,Semiárido Nordeste II,13,5,24,0,42
2907905,Cipó,17,Semiárido Nordeste II,8,0,15,0,23
2908002,Coaraci,5,Litoral Sul,12,2,23,0,37
2908101,Cocos,23,Bacia do Rio Corrente,12,0,14,0,26
2908200,Conceição da Feira,19,Portal do Sertão,14,1,18,1,34
2908309,Conceição do Almeida,21,Recôncavo,15,0,17,0,32
2908408,Conceição do Coité,4,Sisal,33,26,46,5,110
2908507,Conceição do Jacuípe,19,Portal do Sertão,39,12,28,1,80
2908606,Conde,18,Litoral Norte e Agreste Baiano,14,0,16,0,30
2908705,Condeúba,20,Sudoeste Baiano,10,3,26,0,39
2908804,Contendas do Sincorá,13,Sertão Produtivo,3,0,4,0,7
2908903,Coração de Maria,19,Portal do Sertão,13,0,20,0,33
2909000,Cordeiros,20,Sudoeste Baiano,8,0,11,0,19
2909109,Coribe,23,Bacia do Rio Corrente,13,0,21,0,34
2909208,Coronel João Sá,17,Semiárido Nordeste II,8,0,10,0,18
2909307,Correntina,23,Bacia do Rio Corrente,8,0,18,1,27
2909406,Cotegipe,11,Bacia do Rio Grande,4,0,10,0,14
2909505,Cravolândia,9,Vale do Jiquiriçá,3,0,5,0,8
2909604,Crisópolis,18,Litoral Norte e Agreste Baiano,14,0,18,0,32
2909703,Cristópolis,11,Bacia do Rio Grande,6,0,14,0,20
2909802,Cruz das Almas,21,Recôncavo,55,42,54,5,156
2909901,Curaçá,10,Sertão do São Francisco,15,0,22,0,37
2910008,Dário Meira,22,Médio Rio de Contas,0,0,10,0,10
2910057,Dias D'Ávila,26,Metropolitano de Salvador,38,23,53,4,118
2910107,Dom Basílio,13,Sertão Produtivo,8,0,10,0,18
2910206,Dom Macedo Costa,21,Recôncavo,3,0,5,0,8
2910305,Elísio Medrado,9,Vale do Jiquiriçá,2,0,8,0,10
2910404,Encruzilhada,20,Sudoeste Baiano,12,0,14,0,26
2910503,Entre Rios,18,Litoral Norte e Agreste Baiano,22,4,28,0,54
2910602,Esplanada,18,Litoral Norte e Agreste Baiano,11,2,26,0,39
2910701,Euclides da Cunha,17,Semiárido Nordeste II,34,4,53,1,92
2910727,Eunápolis,27,Costa do Descobrimento,131,47,137,10,325
2910750,Fátima,17,Semiárido Nordeste II,6,1,19,0,26
2910776,Feira da Mata,2,Velho Chico,3,0,5,0,8
2910800,Feira de Santana,19,Portal do Sertão,890,133,865,36,1924
2910859,Filadélfia,25,Piemonte Norte do Itapicuru,12,0,14,0,26
2910909,Firmino Alves,8,Médio Sudoeste da Bahia,2,0,2,0,4
2911006,Floresta Azul,5,Litoral Sul,4,0,9,0,13
2911105,Formosa do Rio Preto,11,Bacia do Rio Grande,4,0,18,0,22
2911204,Gandu,6,Baixo Sul,15,20,24,1,60
2911253,Gavião,15,Bacia do Jacuípe,1,0,5,0,6
2911303,Gentio do Ouro,1,Irecê,4,0,7,0,11
2911402,Glória,24,Itaparica,8,0,6,0,14
2911501,Gongogi,22,Médio Rio de Contas,6,0,7,0,13
2911600,Governador Mangabeira,21,Recôncavo,12,1,14,2,29
2911659,Guajeru,20,Sudoeste Baiano,7,0,8,0,15
2911709,Guanambi,13,Sertão Produtivo,155,22,174,3,354
2911808,Guaratinga,27,Costa do Descobrimento,6,0,20,0,26
2911857,Heliópolis,17,Semiárido Nordeste II,4,0,6,0,10
2911907,Iaçu,14,Piemonte do Paraguaçu,16,2,16,0,34
2912004,Ibiassucê,13,Sertão Produtivo,4,0,13,0,17
2912103,Ibicaraí,5,Litoral Sul,12,0,26,0,38
2912202,Ibicoara,3,Chapada Diamantina,6,1,14,0,21
2912301,Ibicuí,8,Médio Sudoeste da Bahia,6,3,19,0,28
2912400,Ibipeba,1,Irecê,4,1,13,2,20
2912509,Ibipitanga,12,Bacia do Paramirim,4,1,12,0,17
2912608,Ibiquera,14,Piemonte do Paraguaçu,1,0,4,0,5
2912707,Ibirapitanga,6,Baixo Sul,9,0,13,0,22
2912806,Ibirapoã,7,Extremo Sul,6,0,6,0,12
2912905,Ibirataia,22,Médio Rio de Contas,9,0,13,0,22
2913002,Ibitiara,3,Chapada Diamantina,6,0,9,0,15
2913101,Ibititá,1,Irecê,6,1,10,0,17
2913200,Ibotirama,2,Velho Chico,15,6,38,0,59
2913309,Ichu,4,Sisal,5,0,6,0,11
2913408,Igaporã,2,Velho Chico,4,0,16,0,20
2913457,Igrapiúna,6,Baixo Sul,8,0,15,0,23
2913507,Iguaí,8,Médio Sudoeste da Bahia,10,0,13,0,23
2913606,Ilhéus,5,Litoral Sul,198,71,229,13,511
2913705,Inhambupe,18,Litoral Norte e Agreste Baiano,18,0,26,0,44
2913804,Ipecaetá,19,Portal do Sertão,5,0,10,0,15
2913903,Ipiaú,22,Médio Rio de Contas,47,12,56,3,118
2914000,Ipirá,15,Bacia do Jacuípe,17,5,31,2,55
2914109,Ipupiara,1,Irecê,3,0,10,0,13
2914208,Irajuba,9,Vale do Jiquiriçá,1,0,7,0,8
2914307,Iramaia,3,Chapada Diamantina,6,0,8,0,14
2914406,Iraquara,3,Chapada Diamantina,13,1,6,0,20
2914505,Irará,19,Portal do Sertão,7,4,18,0,29
2914604,Irecê,1,Irecê,141,10,117,2,270
2914653,Itabela,27,Costa do Descobrimento,11,3,29,0,43
2914703,Itaberaba,14,Piemonte do Paraguaçu,29,14,50,3,96
2914802,Itabuna,5,Litoral Sul,364,46,353,26,789
2914901,Itacaré,5,Litoral Sul,18,3,19,0,40
2915007,Itaetê,3,Chapada Diamantina,2,0,13,0,15
2915106,Itagi,22,Médio Rio de Contas,3,0,12,0,15
2915205,Itagibá,22,Médio Rio de Contas,6,0,12,0,18
2915304,Itagimirim,27,Costa do Descobrimento,3,0,4,0,7
2915353,Itaguaçu da Bahia,1,Irecê,6,0,10,0,16
2915403,Itaju do Colônia,5,Litoral Sul,3,0,7,0,10
2915502,Itajuípe,5,Litoral Sul,4,0,18,0,22
2915601,Itamaraju,7,Extremo Sul,39,8,64,4,115
2915700,Itamari,22,Médio Rio de Contas,1,0,5,0,6
2915809,Itambé,8,Médio Sudoeste da Bahia,13,0,21,0,34
2915908,Itanagra,18,Litoral Norte e Agreste Baiano,4,0,7,0,11
2916005,Itanhém,7,Extremo Sul,10,2,16,0,28
2916104,Itaparica,26,Metropolitano de Salvador,24,3,23,0,50
2916203,Itapé,5,Litoral Sul,2,0,13,0,15
2916302,Itapebi,27,Costa do Descobrimento,4,0,12,0,16
2916401,Itapetinga,8,Médio Sudoeste da Bahia,52,21,74,1,148
2916500,Itapicuru,18,Litoral Norte e Agreste Baiano,21,0,27,0,48
2916609,Itapitanga,5,Litoral Sul,3,0,9,0,12
2916708,Itaquara,9,Vale do Jiquiriçá,3,0,9,0,12
2916807,Itarantim,8,Médio Sudoeste da Bahia,7,1,15,1,24
2916856,Itatim,14,Piemonte do Paraguaçu,10,0,16,0,26
2916906,Itiruçu,9,Vale do Jiquiriçá,2,0,9,0,11
2917003,Itiúba,4,Sisal,10,1,9,0,20
2917102,Itororó,8,Médio Sudoeste da Bahia,8,1,13,0,22
2917201,Ituaçu,13,Sertão Produtivo,9,1,19,0,29
2917300,Ituberá,6,Baixo Sul,5,3,13,2,23
2917334,Iuiu,13,Sertão Produtivo,5,0,8,0,13
2917359,Jaborandi,23,Bacia do Rio Corrente,3,0,11,0,14
2917409,Jacaraci,20,Sudoeste Baiano,5,0,16,0,21
2917508,Jacobina,16,Piemonte da Diamantina,50,39,70,6,165
2917607,Jaguaquara,9,Vale do Jiquiriçá,19,8,48,1,76
2917706,Jaguarari,25,Piemonte Norte do Itapicuru,15,1,9,3,28
2917805,Jaguaripe,6,Baixo Sul,6,0,9,0,15
2917904,Jandaíra,18,Litoral Norte e Agreste Baiano,3,0,3,0,6
2918001,Jequié,22,Médio Rio de Contas,180,52,308,13,553
2918100,Jeremoabo,17,Semiárido Nordeste II,14,1,44,1,60
2918209,Jiquiriçá,9,Vale do Jiquiriçá,9,0,12,0,21
2918308,Jitaúna,22,Médio Rio de Contas,1,0,14,0,15
2918357,João Dourado,1,Irecê,3,0,10,0,13
2918407,Juazeiro,10,Sertão do São Francisco,339,142,293,2,776
2918456,Jucuruçu,7,Extremo Sul,4,0,9,0,13
2918506,Jussara,1,Irecê,4,0,12,0,16
2918555,Jussari,5,Litoral Sul,4,0,8,0,12
2918605,Jussiape,3,Chapada Diamantina,6,0,10,0,16
2918704,Lafayette Coutinho,9,Vale do Jiquiriçá,1,0,7,0,8
2918753,Lagoa Real,13,Sertão Produtivo,2,0,10,0,12
2918803,Laje,9,Vale do Jiquiriçá,13,1,22,0,36
2918902,Lajedão,7,Extremo Sul,2,0,12,0,14
2919009,Lajedinho,14,Piemonte do Paraguaçu,0,0,-,0,0
2919058,Lajedo do Tabocal,9,Vale do Jiquiriçá,1,0,10,0,11
2919108,Lamarão,4,Sisal,0,0,8,0,8
2919157,Lapão,1,Irecê,6,0,18,0,24
2919207,Lauro de Freitas,26,Metropolitano de Salvador,235,238,178,20,671
2919306,Lençóis,3,Chapada Diamantina,4,0,15,0,19
2919405,Licínio de Almeida,20,Sudoeste Baiano,3,0,11,0,14
2919504,Livramento de Nossa Senhora,13,Sertão Produtivo,13,8,50,5,76
2919553,Luís Eduardo Magalhães,11,Bacia do Rio Grande,48,16,59,2,125
2919603,Macajuba,14,Piemonte do Paraguaçu,5,0,6,0,11
2919702,Macarani,8,Médio Sudoeste da Bahia,7,0,17,0,24
2919801,Macaúbas,12,Bacia do Paramirim,22,0,46,0,68
2919900,Macururé,24,Itaparica,3,0,8,0,11
2919926,Madre de Deus,26,Metropolitano de Salvador,18,1,22,1,42
2919959,Maetinga,20,Sudoeste Baiano,9,0,12,0,21
2920007,Maiquinique,8,Médio Sudoeste da Bahia,3,0,7,0,10
2920106,Mairi,15,Bacia do Jacuípe,12,1,28,0,41
2920205,Malhada,2,Velho Chico,1,0,10,0,11
2920304,Malhada de Pedras,13,Sertão Produtivo,2,0,6,0,8
2920403,Manoel Vitorino,22,Médio Rio de Contas,1,0,16,0,17
2920452,Mansidão,11,Bacia do Rio Grande,5,0,6,0,11
2920502,Maracás,9,Vale do Jiquiriçá,6,1,24,0,31
2920601,Maragogipe,21,Recôncavo,13,0,22,0,35
2920700,Maraú,5,Litoral Sul,5,0,15,0,20
2920809,Marcionílio Souza,3,Chapada Diamantina,3,0,3,0,6
2920908,Mascote,5,Litoral Sul,3,0,14,0,17
2921005,Mata de São João,26,Metropolitano de Salvador,28,3,31,1,63
2921054,Matina,2,Velho Chico,3,0,10,0,13
2921104,Medeiros Neto,7,Extremo Sul,17,0,20,0,37
2921203,Miguel Calmon,16,Piemonte da Diamantina,11,2,28,1,42
2921302,Milagres,9,Vale do Jiquiriçá,3,0,10,0,13
2921401,Mirangaba,16,Piemonte da Diamantina,6,0,9,0,15
2921450,Mirante,20,Sudoeste Baiano,4,1,7,0,12
2921500,Monte Santo,4,Sisal,12,0,20,0,32
2921609,Morpará,2,Velho Chico,5,0,11,0,16
2921708,Morro do Chapéu,3,Chapada Diamantina,23,0,34,0,57
2921807,Mortugaba,20,Sudoeste Baiano,7,1,14,1,23
2921906,Mucugê,3,Chapada Diamantina,5,0,13,0,18
2922003,Mucuri,7,Extremo Sul,41,7,34,0,82
2922052,Mulungu do Morro,1,Irecê,4,0,8,0,12
2922102,Mundo Novo,14,Piemonte do Paraguaçu,6,0,9,0,15
2922201,Muniz Ferreira,21,Recôncavo,4,0,6,0,10
2922250,Muquém do São Francisco,2,Velho Chico,1,0,8,0,9
2922300,Muritiba,21,Recôncavo,10,3,29,0,42
2922409,Mutuípe,9,Vale do Jiquiriçá,8,6,17,0,31
2922508,Nazaré,21,Recôncavo,18,3,34,1,56
2922607,Nilo Peçanha,6,Baixo Sul,4,0,10,0,14
2922656,Nordestina,4,Sisal,6,0,11,0,17
2922706,Nova Canaã,8,Médio Sudoeste da Bahia,6,0,14,0,20
2922730,Nova Fátima,15,Bacia do Jacuípe,1,2,12,1,16
2922755,Nova Ibiá,22,Médio Rio de Contas,1,0,8,0,9
2922805,Nova Itarana,9,Vale do Jiquiriçá,3,0,3,0,6
2922854,Nova Redenção,3,Chapada Diamantina,4,0,5,0,9
2922904,Nova Soure,17,Semiárido Nordeste II,8,1,20,0,29
2923001,Nova Viçosa,7,Extremo Sul,21,1,27,0,49
2923035,Novo Horizonte,3,Chapada Diamantina,4,0,7,0,11
2923050,Novo Triunfo,17,Semiárido Nordeste II,4,0,6,0,10
2923100,Olindina,18,Litoral Norte e Agreste Baiano,7,1,14,0,22
2923209,Oliveira dos Brejinhos,2,Velho Chico,7,0,12,0,19
2923308,Ouriçangas,18,Litoral Norte e Agreste Baiano,4,0,5,0,9
2923357,Ourolândia,16,Piemonte da Diamantina,5,2,10,1,18
2923407,Palmas de Monte Alto,13,Sertão Produtivo,7,0,11,0,18
2923506,Palmeiras,3,Chapada Diamantina,5,0,6,1,12
2923605,Paramirim,12,Bacia do Paramirim,16,6,35,4,61
2923704,Paratinga,2,Velho Chico,5,0,17,0,22
2923803,Paripiranga,17,Semiárido Nordeste II,10,3,19,0,32
2923902,Pau-Brasil,5,Litoral Sul,4,0,12,0,16
2924009,Paulo Afonso,24,Itaparica,108,50,93,8,259
2924058,Pé de Serra,15,Bacia do Jacuípe,7,1,14,0,22
2924108,Pedrão,18,Litoral Norte e Agreste Baiano,3,0,6,0,9
2924207,Pedro Alexandre,17,Semiárido Nordeste II,5,0,13,0,18
2924306,Piatã,3,Chapada Diamantina,5,1,14,0,20
2924405,Pilão Arcado,10,Sertão do São Francisco,7,0,12,0,19
2924504,Pindaí,13,Sertão Produtivo,1,0,13,0,14
2924603,Pindobaçu,25,Piemonte Norte do Itapicuru,3,0,7,0,10
2924652,Pintadas,15,Bacia do Jacuípe,2,0,7,0,9
2924678,Piraí do Norte,6,Baixo Sul,0,0,7,0,7
2924702,Piripá,20,Sudoeste Baiano,3,0,17,0,20
2924801,Piritiba,14,Piemonte do Paraguaçu,7,0,13,0,20
2924900,Planaltino,9,Vale do Jiquiriçá,1,0,5,0,6
2925006,Planalto,20,Sudoeste Baiano,6,0,17,0,23
2925105,Poções,20,Sudoeste Baiano,16,8,36,0,60
2925204,Pojuca,26,Metropolitano de Salvador,29,3,40,0,72
2925253,Ponto Novo,25,Piemonte Norte do Itapicuru,3,0,5,0,8
2925303,Porto Seguro,27,Costa do Descobrimento,98,32,167,4,301
2925402,Potiraguá,8,Médio Sudoeste da Bahia,3,0,9,0,12
2925501,Prado,7,Extremo Sul,16,1,29,0,46
2925600,Presidente Dutra,1,Irecê,1,0,16,0,17
2925709,Presidente Jânio Quadros,20,Sudoeste Baiano,5,0,14,1,20
2925758,Presidente Tancredo Neves,6,Baixo Sul,11,4,19,1,35
2925808,Queimadas,4,Sisal,7,1,15,0,23
2925907,Quijingue,4,Sisal,9,0,15,0,24
2925931,Quixabeira,15,Bacia do Jacuípe,1,0,7,0,8
2925956,Rafael Jambeiro,14,Piemonte do Paraguaçu,10,0,23,0,33
2926004,Remanso,10,Sertão do São Francisco,21,5,26,3,55
2926103,Retirolândia,4,Sisal,8,0,14,0,22
2926202,Riachão das Neves,11,Bacia do Rio Grande,4,0,16,0,20
2926301,Riachão do Jacuípe,15,Bacia do Jacuípe,11,1,29,4,45
2926400,Riacho de Santana,2,Velho Chico,9,1,22,0,32
2926509,Ribeira do Amparo,17,Semiárido Nordeste II,7,0,15,0,22
2926608,Ribeira do Pombal,17,Semiárido Nordeste II,24,4,57,2,87
2926657,Ribeirão do Largo,20,Sudoeste Baiano,3,0,7,0,10
2926707,Rio de Contas,3,Chapada Diamantina,3,0,12,0,15
2926806,Rio do Antônio,13,Sertão Produtivo,3,0,8,1,12
2926905,Rio do Pires,12,Bacia do Paramirim,5,0,8,0,13
2927002,Rio Real,18,Litoral Norte e Agreste Baiano,14,0,27,0,41
2927101,Rodelas,24,Itaparica,9,0,10,0,19
2927200,Ruy Barbosa,14,Piemonte do Paraguaçu,17,1,29,0,47
2927309,Salinas da Margarida,21,Recôncavo,7,0,19,0,26
2927507,Santa Bárbara,19,Portal do Sertão,6,1,17,0,24
2927606,Santa Brígida,17,Semiárido Nordeste II,2,0,15,0,17
2927705,Santa Cruz Cabrália,27,Costa do Descobrimento,12,0,18,0,30
2927804,Santa Cruz da Vitória,8,Médio Sudoeste da Bahia,5,0,7,0,12
2927903,Santa Inês,9,Vale do Jiquiriçá,3,1,13,0,17
2928000,Santaluz,4,Sisal,22,1,40,1,64
2928059,Santa Luzia,5,Litoral Sul,2,0,14,0,16
2928109,Santa Maria da Vitória,23,Bacia do Rio Corrente,22,3,36,0,61
2928208,Santana,23,Bacia do Rio Corrente,12,0,12,0,24
2928307,Santanópolis,19,Portal do Sertão,2,0,6,0,8
2928406,Santa Rita de Cássia,11,Bacia do Rio Grande,11,0,26,0,37
2928505,Santa Terezinha,14,Piemonte do Paraguaçu,4,0,9,0,13
2928604,Santo Amaro,21,Recôncavo,40,6,44,0,90
2928703,Santo Antônio de Jesus,21,Recôncavo,106,34,103,41,284
2928802,Santo Estevão,19,Portal do Sertão,15,2,31,0,48
2928901,São Desidério,11,Bacia do Rio Grande,7,0,26,0,33
2928950,São Domingos,4,Sisal,8,0,7,0,15
2929008,São Félix,21,Recôncavo,23,0,24,0,47
2929057,São Félix do Coribe,23,Bacia do Rio Corrente,6,0,14,0,20
2929107,São Felipe,21,Recôncavo,9,1,16,0,26
2929206,São Francisco do Conde,26,Metropolitano de Salvador,29,5,67,0,101
2929255,São Gabriel,1,Irecê,2,0,9,0,11
2929305,São Gonçalo dos Campos,19,Portal do Sertão,9,3,16,0,28
2929354,São José da Vitória,5,Litoral Sul,0,0,3,0,3
2929370,São José do Jacuípe,15,Bacia do Jacuípe,1,0,6,0,7
2929404,São Miguel das Matas,9,Vale do Jiquiriçá,4,0,6,0,10
2929503,São Sebastião do Passé,26,Metropolitano de Salvador,21,3,33,0,57
2929602,Sapeaçu,21,Recôncavo,7,0,24,0,31
2929701,Sátiro Dias,18,Litoral Norte e Agreste Baiano,6,0,15,0,21
2929750,Saubara,21,Recôncavo,4,0,8,0,12
2929800,Saúde,16,Piemonte da Diamantina,3,0,6,0,9
2929909,Seabra,3,Chapada Diamantina,23,4,34,2,63
2930006,Sebastião Laranjeiras,13,Sertão Produtivo,4,0,12,0,16
2930105,Senhor do Bonfim,25,Piemonte Norte do Itapicuru,29,19,32,4,84
2930154,Serra do Ramalho,2,Velho Chico,4,0,19,0,23
2930204,Sento Sé,10,Sertão do São Francisco,8,0,18,0,26
2930303,Serra Dourada,23,Bacia do Rio Corrente,7,0,13,0,20
2930402,Serra Preta,15,Bacia do Jacuípe,5,0,14,0,19
2930501,Serrinha,4,Sisal,22,13,67,2,104
2930600,Serrolândia,16,Piemonte da Diamantina,3,0,8,0,11
2930709,Simões Filho,26,Metropolitano de Salvador,72,5,72,3,152
2930758,Sítio do Mato,2,Velho Chico,5,0,13,0,18
2930766,Sítio do Quinto,17,Semiárido Nordeste II,3,0,8,1,12
2930774,Sobradinho,10,Sertão do São Francisco,12,0,13,0,25
2930808,Souto Soares,3,Chapada Diamantina,1,0,7,0,8
2930907,Tabocas do Brejo Velho,23,Bacia do Rio Corrente,3,0,11,0,14
2931004,Tanhaçu,13,Sertão Produtivo,7,1,17,0,25
2931053,Tanque Novo,13,Sertão Produtivo,6,0,12,0,18
2931103,Tanquinho,19,Portal do Sertão,2,0,5,0,7
2931202,Taperoá,6,Baixo Sul,9,0,12,0,21
2931301,Tapiramutá,14,Piemonte do Paraguaçu,7,0,5,0,12
2931350,Teixeira de Freitas,7,Extremo Sul,150,62,120,30,362
2931400,Teodoro Sampaio,19,Portal do Sertão,2,1,6,0,9
2931509,Teofilândia,4,Sisal,7,0,14,0,21
2931608,Teolândia,6,Baixo Sul,6,0,16,0,22
2931707,Terra Nova,19,Portal do Sertão,6,0,14,0,20
2931806,Tremedal,20,Sudoeste Baiano,7,0,19,0,26
2931905,Tucano,4,Sisal,18,0,38,0,56
2932002,Uauá,10,Sertão do São Francisco,5,2,6,0,13
2932101,Ubaíra,9,Vale do Jiquiriçá,7,0,13,0,20
2932200,Ubaitaba,5,Litoral Sul,6,0,17,0,23
2932309,Ubatã,22,Médio Rio de Contas,5,0,15,0,20
2932408,Uibaí,1,Irecê,4,0,7,0,11
2932457,Umburanas,16,Piemonte da Diamantina,4,0,8,0,12
2932507,Una,5,Litoral Sul,13,0,30,0,43
2932606,Urandi,13,Sertão Produtivo,8,1,12,0,21
2932705,Uruçuca,5,Litoral Sul,9,0,11,0,20
2932804,Utinga,3,Chapada Diamantina,4,0,10,0,14
2932903,Valença,6,Baixo Sul,36,14,56,7,113
2933000,Valente,4,Sisal,11,0,16,0,27
2933059,Várzea da Roça,15,Bacia do Jacuípe,4,0,10,0,14
2933109,Várzea do Poço,15,Bacia do Jacuípe,0,0,6,0,6
2933158,Várzea Nova,16,Piemonte da Diamantina,2,0,9,0,11
2933174,Varzedo,21,Recôncavo,2,0,8,0,10
2933208,Vera Cruz,26,Metropolitano de Salvador,12,0,41,0,53
2933257,Vereda,7,Extremo Sul,4,0,8,0,12
2933307,Vitória da Conquista,20,Sudoeste Baiano,495,177,367,50,1089
2933406,Wagner,3,Chapada Diamantina,2,0,5,0,7
2933455,Wanderley,11,Bacia do Rio Grande,5,0,12,0,17
2933505,Wenceslau Guimarães,6,Baixo Sul,9,0,23,0,32
2933604,Xique-Xique,1,Irecê,8,1,23,0,32
