Código,Município,Código TI,Território de Identidade,População,QtMédicosSUS,QtMédicosNãoSUS,QtEnfermeirosSUS,QtEnfermeirosNãoSUS,QtProfissionais,Médicos,Enfermeiros,SUS,Não SUS,QtProfissionais/100000Hab,QtMédicos/100000Hab,QtEnfermeiros/100000Hab,QtSUS/100000Hab,QtNãoSUS/100000Hab
2900108,Abaíra,3,Chapada Diamantina,9199,11,0,5,0,16,11,5,16,0,173.9319491249,119.5782150234,54.3537341015,173.9319491249,0
2900207,Abaré,24,Itaparica,20189,2,0,14,0,16,2,14,16,0,79.2510773193,9.9063846649,69.3446926544,79.2510773193,0
2900306,Acajutiba,18,Litoral Norte e Agreste Baiano,15727,4,1,10,0,15,5,10,14,1,95.3773764863,31.7924588288,63.5849176575,89.0188847205,6.3584917658
2900355,Adustina,17,Semiárido Nordeste II,17349,140,0,8,0,148,140,8,148,0,853.0751051934,806.9629373451,46.1121678483,853.0751051934,0
2900405,Água Fria,19,Portal do Sertão,17508,26,0,12,0,38,26,12,38,0,217.0436371944,148.5035412383,68.5400959561,217.0436371944,0
2900504,Érico Cardoso,12,Bacia do Paramirim,11212,2,0,7,0,9,2,7,9,0,80.2711380664,17.8380306814,62.4331073849,80.2711380664,0
2900603,Aiquara,22,Médio Rio de Contas,4725,24,0,5,0,29,24,5,29,0,613.7566137566,507.9365079365,105.8201058201,613.7566137566,0
2900702,Alagoinhas,18,Litoral Norte e Agreste Baiano,155979,12,97,128,9,246,109,137,140,106,157.7135383609,69.8812019567,87.8323364043,89.7556722379,67.957866123
2900801,Alcobaça,7,Extremo Sul,23376,6,0,18,0,24,6,18,24,0,102.6694045175,25.6673511294,77.0020533881,102.6694045175,0
2900900,Almadina,5,Litoral Sul,5985,22,0,5,0,27,22,5,27,0,451.1278195489,367.5856307435,83.5421888053,451.1278195489,0
2901007,Amargosa,9,Vale do Jiquiriçá,38259,9,11,30,0,50,20,30,39,11,130.6882040827,52.2752816331,78.4129224496,101.9367991845,28.7514048982
2901106,Amélia Rodrigues,19,Portal do Sertão,26409,5,1,10,0,16,6,10,15,1,60.5854064902,22.7195274338,37.8658790564,56.7988185846,3.7865879056
2901155,América Dourada,1,Irecê,16798,6,0,11,0,17,6,11,17,0,101.20252411,35.7185379212,65.4839861888,101.20252411,0
2901205,Anagé,20,Sudoeste Baiano,19568,10,0,19,0,29,10,19,29,0,148.2011447261,51.103843009,97.0973017171,148.2011447261,0
2901304,Andaraí,3,Chapada Diamantina,13737,14,0,9,0,23,14,9,23,0,167.431025697,101.9145373808,65.5164883162,167.431025697,0
2901353,Andorinha,25,Piemonte Norte do Itapicuru,15490,3,1,8,0,12,4,8,11,1,77.4693350549,25.823111685,51.6462233699,71.0135571336,6.4557779212
2901403,Angical,11,Bacia do Rio Grande,14690,5,0,4,0,9,5,4,9,0,61.2661674609,34.0367597005,27.2294077604,61.2661674609,0
2901502,Anguera,19,Portal do Sertão,11481,9,0,10,0,19,9,10,19,0,165.490810905,78.3903841129,87.1004267921,165.490810905,0
2901601,Antas,17,Semiárido Nordeste II,19569,5,0,17,0,22,5,17,22,0,112.4227093873,25.5506157698,86.8720936175,112.4227093873,0
2901700,Antônio Cardoso,19,Portal do Sertão,12208,9,0,7,0,16,9,7,16,0,131.0615989515,73.7221494102,57.3394495413,131.0615989515,0
2901809,Antônio Gonçalves,25,Piemonte Norte do Itapicuru,12072,11,1,8,0,20,12,8,19,1,165.6726308814,99.4035785288,66.2690523526,157.3889993373,8.2836315441
2901908,Aporá,18,Litoral Norte e Agreste Baiano,18334,19,0,6,0,25,19,6,25,0,136.3586778663,103.6325951784,32.7260826879,136.3586778663,0
2901957,Apuarema,22,Médio Rio de Contas,7730,2,0,6,0,8,2,6,8,0,103.4928848642,25.873221216,77.6196636481,103.4928848642,0
2902005,Aracatu,20,Sudoeste Baiano,13962,2,0,11,0,13,2,11,13,0,93.1098696462,14.3245953302,78.785274316,93.1098696462,0
2902054,Araçás,18,Litoral Norte e Agreste Baiano,12608,3,0,10,0,13,3,10,13,0,103.1091370558,23.7944162437,79.3147208122,103.1091370558,0
2902104,Araci,4,Sisal,55935,7,3,36,0,46,10,36,43,3,82.2383123268,17.8778939841,64.3604183427,76.8749441316,5.3633681952
2902203,Aramari,18,Litoral Norte e Agreste Baiano,11703,7,0,7,0,14,7,7,14,0,119.627445954,59.813722977,59.813722977,119.627445954,0
2902252,Arataca,5,Litoral Sul,11661,7,0,6,0,13,7,6,13,0,111.4827201784,60.0291570191,51.4535631592,111.4827201784,0
2902302,Aratuípe,6,Baixo Sul,9171,7,0,4,0,11,7,4,11,0,119.9432995311,76.3275542471,43.615745284,119.9432995311,0
2902401,Aurelino Leal,5,Litoral Sul,12706,31,0,11,0,42,31,11,42,0,330.5524948843,243.9792224146,86.5732724697,330.5524948843,0
2902500,Baianópolis,11,Bacia do Rio Grande,14323,15,0,14,0,29,15,14,29,0,202.4715492564,104.7266634085,97.7448858479,202.4715492564,0
2902609,Baixa Grande,15,Bacia do Jacuípe,21403,25,0,2,0,27,25,2,27,0,126.150539644,116.8060552259,9.3444844181,126.150539644,0
2902658,Banzaê,17,Semiárido Nordeste II,13765,5,0,18,0,23,5,18,23,0,167.0904467853,36.3240101707,130.7664366146,167.0904467853,0
2902708,Barra,2,Velho Chico,54915,4,0,36,0,40,4,36,40,0,72.8398433943,7.2839843394,65.5558590549,72.8398433943,0
2902807,Barra da Estiva,3,Chapada Diamantina,22082,219,1,23,0,243,220,23,242,1,1100.4438003804,996.2865682456,104.1572321348,1095.9152250702,4.5285753102
2902906,Barra do Choça,20,Sudoeste Baiano,34121,8,1,21,0,30,9,21,29,1,87.9223938337,26.3767181501,61.5456756836,84.9916473726,2.9307464611
2903003,Barra do Mendes,1,Irecê,14560,8,0,19,0,27,8,19,27,0,185.4395604396,54.9450549451,130.4945054945,185.4395604396,0
2903102,Barra do Rocha,22,Médio Rio de Contas,6258,6,0,3,0,9,6,3,9,0,143.815915628,95.8772770853,47.9386385427,143.815915628,0
2903201,Barreiras,11,Bacia do Rio Grande,157638,17,41,237,3,298,58,240,254,44,189.0407135335,36.7931590099,152.2475545237,161.1286618709,27.9120516627
2903235,Barro Alto,1,Irecê,15217,15,0,7,0,22,15,7,22,0,144.575146218,98.5739633305,46.0011828876,144.575146218,0
2903276,Barrocas,4,Sisal,16296,7,1,15,0,23,8,15,22,1,141.1389297987,49.0918016691,92.0471281296,135.0024545901,6.1364752086
2903300,Barro Preto,5,Litoral Sul,6251,9,0,7,0,16,9,7,16,0,255.9590465526,143.9769636858,111.9820828667,255.9590465526,0
2903409,Belmonte,27,Costa do Descobrimento,24013,12,0,18,0,30,12,18,30,0,124.9323283222,49.9729313289,74.9593969933,124.9323283222,0
2903508,Belo Campo,20,Sudoeste Baiano,18247,51,0,21,0,72,51,21,72,0,394.5854113005,279.4979996712,115.0874116293,394.5854113005,0
2903607,Biritinga,4,Sisal,16653,9,0,9,0,18,9,9,18,0,108.0886326788,54.0443163394,54.0443163394,108.0886326788,0
2903706,Boa Nova,22,Médio Rio de Contas,14069,4,0,12,0,16,4,12,16,0,113.7252114578,28.4313028645,85.2939085934,113.7252114578,0
2903805,Boa Vista do Tupim,14,Piemonte do Paraguaçu,19502,6,0,10,0,16,6,10,16,0,82.0428673982,30.7660752743,51.2767921239,82.0428673982,0
2903904,Bom Jesus da Lapa,2,Velho Chico,70618,9,9,81,0,99,18,81,90,9,140.1908861763,25.4892520321,114.7016341443,127.4462601603,12.744626016
2903953,Bom Jesus da Serra,20,Sudoeste Baiano,10477,7,0,7,0,14,7,7,14,0,133.626037988,66.813018994,66.813018994,133.626037988,0
2904001,Boninal,3,Chapada Diamantina,14760,2,0,7,0,9,2,7,9,0,60.9756097561,13.5501355014,47.4254742547,60.9756097561,0
2904050,Bonito,3,Chapada Diamantina,17131,5,0,10,0,15,5,10,15,0,87.5605627225,29.1868542409,58.3737084817,87.5605627225,0
2904100,Boquira,12,Bacia do Paramirim,22464,4,0,5,0,9,4,5,9,0,40.0641025641,17.8062678063,22.2578347578,40.0641025641,0
2904209,Botuporã,12,Bacia do Paramirim,10898,57,0,5,0,62,57,5,62,0,568.9117269224,523.0317489448,45.8799779776,568.9117269224,0
2904308,Brejões,9,Vale do Jiquiriçá,15122,7,0,5,0,12,7,5,12,0,79.3545827272,46.2901732575,33.0644094696,79.3545827272,0
2904407,Brejolândia,23,Bacia do Rio Corrente,10833,5,0,6,0,11,5,6,11,0,101.541585895,46.1552663159,55.3863195791,101.541585895,0
2904506,Brotas de Macaúbas,2,Velho Chico,10974,9,0,8,0,17,9,8,17,0,154.9116092582,82.0120284308,72.8995808274,154.9116092582,0
2904605,Brumado,13,Sertão Produtivo,69677,5,26,66,3,100,31,69,71,29,143.5193822926,44.4910085107,99.0283737819,101.8987614277,41.6206208648
2904704,Buerarema,5,Litoral Sul,19256,27,0,10,0,37,27,10,37,0,192.1479019526,140.21603656,51.9318653926,192.1479019526,0
2904753,Buritirama,11,Bacia do Rio Grande,21786,11,0,10,0,21,11,10,21,0,96.3921784632,50.4911410998,45.9010373634,96.3921784632,0
2904803,Caatiba,8,Médio Sudoeste da Bahia,7841,10,0,6,0,16,10,6,16,0,204.0556051524,127.5347532203,76.5208519322,204.0556051524,0
2904852,Cabaceiras do Paraguaçu,21,Recôncavo,19312,4,0,12,0,16,4,12,16,0,82.850041425,20.7125103563,62.1375310688,82.850041425,0
2904902,Cachoeira,21,Recôncavo,35139,56,6,27,0,89,62,27,83,6,253.2798315262,176.4421298273,76.837701699,236.2047867042,17.075044822
2905008,Caculé,13,Sertão Produtivo,23817,9,12,19,1,41,21,20,28,13,172.1459461729,88.1723138934,83.9736322795,117.5630851913,54.5828609817
2905107,Caém,16,Piemonte da Diamantina,10058,7,0,6,0,13,7,6,13,0,129.2503479817,69.5963412209,59.6540067608,129.2503479817,0
2905156,Caetanos,20,Sudoeste Baiano,16106,6,0,9,0,15,6,9,15,0,93.1329939153,37.2531975661,55.8797963492,93.1329939153,0
2905206,Caetité,13,Sertão Produtivo,52853,34,9,37,0,80,43,37,71,9,151.3632149547,81.3577280381,70.0054869165,134.3348532723,17.0283616824
2905305,Cafarnaum,1,Irecê,19006,347,0,12,0,359,347,12,359,0,1888.8771966747,1825.7392402399,63.1379564348,1888.8771966747,0
2905404,Cairu,6,Baixo Sul,18224,11,0,12,0,23,11,12,23,0,126.2071992976,60.3599648815,65.8472344162,126.2071992976,0
2905503,Caldeirão Grande,25,Piemonte Norte do Itapicuru,13713,7,0,7,0,14,7,7,14,0,102.0929045431,51.0464522716,51.0464522716,102.0929045431,0
2905602,Camacan,5,Litoral Sul,33310,37,0,22,0,59,37,22,59,0,177.1239867908,111.0777544281,66.0462323627,177.1239867908,0
2905701,Camaçari,26,Metropolitano de Salvador,296893,5,99,249,14,367,104,263,254,113,123.6135577464,35.0294550562,88.5841026902,85.5527075411,38.0608502053
2905800,Camamu,6,Baixo Sul,36644,12,4,15,1,32,16,16,27,5,87.3267110577,43.6633555289,43.6633555289,73.681912455,13.6447986028
2905909,Campo Alegre de Lourdes,10,Sertão do São Francisco,30048,16,0,15,0,31,16,15,31,0,103.1682641108,53.2481363152,49.9201277955,103.1682641108,0
2906006,Campo Formoso,25,Piemonte Norte do Itapicuru,73448,5,4,26,0,35,9,26,31,4,47.6527611371,12.2535671495,35.3991939876,42.2067312929,5.4460298442
2906105,Canápolis,23,Bacia do Rio Corrente,10151,39,0,6,0,45,39,6,45,0,443.3060782189,384.198601123,59.1074770959,443.3060782189,0
2906204,Canarana,1,Irecê,26862,3,0,17,0,20,3,17,20,0,74.4546199092,11.1681929864,63.2864269228,74.4546199092,0
2906303,Canavieiras,5,Litoral Sul,33002,11,5,16,2,34,16,18,27,7,103.0240591479,48.4819101873,54.5421489607,81.813223441,21.2108357069
2906402,Candeal,4,Sisal,8837,21,0,5,0,26,21,5,26,0,294.2174946249,237.637207197,56.5802874279,294.2174946249,0
2906501,Candeias,26,Metropolitano de Salvador,89707,4,44,73,20,141,48,93,77,64,157.178369581,53.5075300701,103.6708395109,85.8349961541,71.3433734268
2906600,Candiba,13,Sertão Produtivo,14792,6,0,4,0,10,6,4,10,0,67.6041103299,40.5624661979,27.041644132,67.6041103299,0
2906709,Cândido Sales,20,Sudoeste Baiano,26674,15,0,18,0,33,15,18,33,0,123.715978106,56.2345355027,67.4814426033,123.715978106,0
2906808,Cansanção,4,Sisal,36191,6,1,19,0,26,7,19,25,1,71.8410654583,19.3418253157,52.4992401426,69.077947556,2.7631179022
2906824,Canudos,10,Sertão do São Francisco,17316,14,0,11,0,25,14,11,25,0,144.3751443751,80.8500808501,63.5250635251,144.3751443751,0
2906857,Capela do Alto Alegre,15,Bacia do Jacuípe,12199,9,0,11,0,20,9,11,20,0,163.9478645791,73.7765390606,90.1713255185,163.9478645791,0
2906873,Capim Grosso,15,Bacia do Jacuípe,31392,10,1,32,0,43,11,32,42,1,136.9775739042,35.0407747197,101.9367991845,133.7920489297,3.1855249745
2906899,Caraíbas,20,Sudoeste Baiano,9773,33,0,12,0,45,33,12,45,0,460.4522664484,337.6649953955,122.7872710529,460.4522664484,0
2906907,Caravelas,7,Extremo Sul,22740,18,0,14,0,32,18,14,32,0,140.7211961302,79.1556728232,61.5655233069,140.7211961302,0
2907004,Cardeal da Silva,18,Litoral Norte e Agreste Baiano,9544,2,0,5,0,7,2,5,7,0,73.3445096396,20.9555741827,52.3889354568,73.3445096396,0
2907103,Carinhanha,2,Velho Chico,30118,26,2,17,0,45,28,17,43,2,149.4123115745,92.9676605352,56.4446510392,142.7717643934,6.6405471811
2907202,Casa Nova,10,Sertão do São Francisco,73382,4,1,14,0,19,5,14,18,1,25.8919080974,6.8136600256,19.0782480717,24.5291760922,1.3627320051
2907301,Castro Alves,21,Recôncavo,27238,11,2,22,1,36,13,23,33,3,132.1682942947,47.7274396064,84.4408546883,121.1542697702,11.0140245246
2907400,Catolândia,11,Bacia do Rio Grande,3669,5,0,4,0,9,5,4,9,0,245.2984464432,136.2769146907,109.0215317525,245.2984464432,0
2907509,Catu,18,Litoral Norte e Agreste Baiano,56459,12,16,32,13,73,28,45,44,29,129.2973662304,49.5935103349,79.7038558954,77.9326590978,51.3647071326
2907558,Caturama,12,Bacia do Paramirim,9764,10,0,9,0,19,10,9,19,0,194.5923801721,102.4170421958,92.1753379762,194.5923801721,0
2907608,Central,1,Irecê,17969,22,0,20,0,42,22,20,42,0,233.7358784573,122.4330791919,111.3027992654,233.7358784573,0
2907707,Chorrochó,24,Itaparica,11591,9,0,9,0,18,9,9,18,0,155.2928996635,77.6464498318,77.6464498318,155.2928996635,0
2907806,Cícero Dantas,17,Semiárido Nordeste II,34676,8,2,21,0,31,10,21,29,2,89.3990079594,28.8383896643,60.5606182951,83.6313300265,5.7676779329
2907905,Cipó,17,Semiárido Nordeste II,17739,10,0,14,0,24,10,14,24,0,135.2951124641,56.3729635267,78.9221489374,135.2951124641,0
2908002,Coaraci,5,Litoral Sul,19022,37,0,22,0,59,37,22,59,0,310.1671748502,194.5116181264,115.6555567238,310.1671748502,0
2908101,Cocos,23,Bacia do Rio Corrente,19498,40,0,15,0,55,40,15,55,0,282.0802133552,205.1492460765,76.9309672787,282.0802133552,0
2908200,Conceição da Feira,19,Portal do Sertão,23024,13,3,14,1,31,16,15,27,4,134.6421125782,69.4927032662,65.149409312,117.2689367616,17.3731758165
2908309,Conceição do Almeida,21,Recôncavo,18229,17,0,16,0,33,17,16,33,0,181.0302265621,93.2579955017,87.7722310604,181.0302265621,0
2908408,Conceição do Coité,4,Sisal,68303,5,17,40,3,65,22,43,45,20,95.1641948377,32.2094197912,62.9547750465,65.8829041184,29.2812907193
2908507,Conceição do Jacuípe,19,Portal do Sertão,33876,10,9,28,1,48,19,29,38,10,141.6932341481,56.0869051836,85.6063289645,112.1738103672,29.5194237808
2908606,Conde,18,Litoral Norte e Agreste Baiano,26371,6,0,15,0,21,6,15,21,0,79.6329301126,22.7522657465,56.8806643662,79.6329301126,0
2908705,Condeúba,20,Sudoeste Baiano,18191,9,3,22,0,34,12,22,31,3,186.9056126656,65.9666868232,120.9389258425,170.4139409598,16.4916717058
2908804,Contendas do Sincorá,13,Sertão Produtivo,4299,5,0,3,0,8,5,3,8,0,186.0897883229,116.3061177018,69.7836706211,186.0897883229,0
2908903,Coração de Maria,19,Portal do Sertão,23896,15,0,14,0,29,15,14,29,0,121.359223301,62.7720120522,58.5872112487,121.359223301,0
2909000,Cordeiros,20,Sudoeste Baiano,8904,5,0,9,0,14,5,9,14,0,157.2327044025,56.1545372866,101.0781671159,157.2327044025,0
2909109,Coribe,23,Bacia do Rio Corrente,14933,3,0,14,0,17,3,14,17,0,113.8418268265,20.0897341459,93.7520926806,113.8418268265,0
2909208,Coronel João Sá,17,Semiárido Nordeste II,16814,15,0,12,0,27,15,12,27,0,160.5804686571,89.2113714762,71.3690971809,160.5804686571,0
2909307,Correntina,23,Bacia do Rio Corrente,33361,6,1,18,1,26,7,19,24,2,77.9353136896,20.9825844549,56.9527292347,71.9402895597,5.99502413
2909406,Cotegipe,11,Bacia do Rio Grande,14414,49,0,9,0,58,49,9,58,0,402.3865686138,339.9472734841,62.4392951297,402.3865686138,0
2909505,Cravolândia,9,Vale do Jiquiriçá,5576,18,0,5,0,23,18,5,23,0,412.4820659971,322.8120516499,89.6700143472,412.4820659971,0
2909604,Crisópolis,18,Litoral Norte e Agreste Baiano,21835,4,0,16,0,20,4,16,20,0,91.5960613694,18.3192122739,73.2768490955,91.5960613694,0
2909703,Cristópolis,11,Bacia do Rio Grande,14403,42,0,11,0,53,42,11,53,0,367.9788932861,291.6059154343,76.3729778518,367.9788932861,0
2909802,Cruz das Almas,21,Recôncavo,64932,5,35,54,4,98,40,58,59,39,150.9271237602,61.6029076572,89.324216103,90.8642887944,60.0628349658
2909901,Curaçá,10,Sertão do São Francisco,35524,6,0,16,0,22,6,16,22,0,61.929962842,16.889989866,45.039972976,61.929962842,0
2910008,Dário Meira,22,Médio Rio de Contas,11716,2,0,9,0,11,2,9,11,0,93.8886992147,17.0706725845,76.8180266302,93.8886992147,0
2910057,Dias D'Ávila,26,Metropolitano de Salvador,80657,9,14,35,2,60,23,37,44,16,74.3890796831,28.5158138785,45.8732658046,54.5519917676,19.8370879155
2910107,Dom Basílio,13,Sertão Produtivo,12604,22,0,14,0,36,22,14,36,0,285.6236115519,174.547762615,111.0758489368,285.6236115519,0
2910206,Dom Macedo Costa,21,Recôncavo,4212,15,0,3,0,18,15,3,18,0,427.3504273504,356.1253561254,71.2250712251,427.3504273504,0
2910305,Elísio Medrado,9,Vale do Jiquiriçá,8461,35,0,4,0,39,35,4,39,0,460.9384233542,413.6626876256,47.2757357286,460.9384233542,0
2910404,Encruzilhada,20,Sudoeste Baiano,19376,122,0,13,0,135,122,13,135,0,696.7382328654,629.6449215524,67.093311313,696.7382328654,0
2910503,Entre Rios,18,Litoral Norte e Agreste Baiano,43223,3,3,38,1,45,6,39,41,4,104.1112370729,13.8814982764,90.2297387965,94.8569048886,9.2543321843
2910602,Esplanada,18,Litoral Norte e Agreste Baiano,37845,3,2,19,0,24,5,19,22,2,63.4165675783,13.2117849121,50.2047826661,58.1318536134,5.2847139649
2910701,Euclides da Cunha,17,Semiárido Nordeste II,61924,784,1,44,0,829,785,44,828,1,1338.7378076352,1267.6829662167,71.0548414185,1337.1229248757,1.6148827595
2910727,Eunápolis,27,Costa do Descobrimento,115290,7,42,116,6,171,49,122,123,48,148.3216237315,42.5015179114,105.8201058201,106.6874837367,41.6341399948
2910750,Fátima,17,Semiárido Nordeste II,18443,1,0,14,0,15,1,14,15,0,81.3316705525,5.4221113702,75.9095591823,81.3316705525,0
2910776,Feira da Mata,2,Velho Chico,5922,4,0,4,0,8,4,4,8,0,135.0894967916,67.5447483958,67.5447483958,135.0894967916,0
2910800,Feira de Santana,19,Portal do Sertão,627477,11,123,750,31,915,134,781,761,154,145.8220779407,21.3553644197,124.466713521,121.2793456971,24.5427322436
2910859,Filadélfia,25,Piemonte Norte do Itapicuru,17176,16,0,13,0,29,16,13,29,0,168.8402421984,93.153237075,75.6870051234,168.8402421984,0
2910909,Firmino Alves,8,Médio Sudoeste da Bahia,5822,3,0,2,0,5,3,2,5,0,85.8811405015,51.5286843009,34.3524562006,85.8811405015,0
2911006,Floresta Azul,5,Litoral Sul,11244,4,0,9,0,13,4,9,13,0,115.6172180719,35.5745286375,80.0426894344,115.6172180719,0
2911105,Formosa do Rio Preto,11,Bacia do Rio Grande,25912,8,0,16,0,24,8,16,24,0,92.6211793764,30.8737264588,61.7474529176,92.6211793764,0
2911204,Gandu,6,Baixo Sul,33234,9,14,22,3,48,23,25,31,17,144.4304025997,69.206234579,75.2241680207,93.2779683457,51.1524342541
2911253,Gavião,15,Bacia do Jacuípe,4725,10,0,2,0,12,10,2,12,0,253.9682539683,211.6402116402,42.328042328,253.9682539683,0
2911303,Gentio do Ouro,1,Irecê,11639,6,0,7,0,13,6,7,13,0,111.693444454,51.5508205172,60.1426239368,111.693444454,0
2911402,Glória,24,Itaparica,15840,120,0,7,0,127,120,7,127,0,801.7676767677,757.5757575758,44.1919191919,801.7676767677,0
2911501,Gongogi,22,Médio Rio de Contas,7848,16,0,10,0,26,16,10,26,0,331.2945973496,203.873598369,127.4209989806,331.2945973496,0
2911600,Governador Mangabeira,21,Recôncavo,21495,3,1,12,1,17,4,13,15,2,79.0881600372,18.6089788323,60.4791812049,69.7836706211,9.3044894161
2911659,Guajeru,20,Sudoeste Baiano,8081,14,0,8,0,22,14,8,22,0,272.2435342161,173.2458854102,98.9976488058,272.2435342161,0
2911709,Guanambi,13,Sertão Produtivo,86808,5,24,144,5,178,29,149,149,29,205.0502257856,33.4070592572,171.6431665284,171.6431665284,33.4070592572
2911808,Guaratinga,27,Costa do Descobrimento,22154,8,0,14,0,22,8,14,22,0,99.3048659384,36.1108603412,63.1940055972,99.3048659384,0
2911857,Heliópolis,17,Semiárido Nordeste II,13718,3,0,7,0,10,3,7,10,0,72.8969237498,21.8690771249,51.0278466249,72.8969237498,0
2911907,Iaçu,14,Piemonte do Paraguaçu,25884,5,1,15,0,21,6,15,20,1,81.1312007418,23.1803430691,57.9508576727,77.2678102303,3.8633905115
2912004,Ibiassucê,13,Sertão Produtivo,10183,7,0,9,1,17,7,10,16,1,166.9449081803,68.7420210154,98.2028871649,157.1246194638,9.8202887165
2912103,Ibicaraí,5,Litoral Sul,23529,2,0,25,0,27,2,25,27,0,114.7520081601,8.5001487526,106.2518594075,114.7520081601,0
2912202,Ibicoara,3,Chapada Diamantina,19786,1,1,9,0,11,2,9,10,1,55.5948650561,10.1081572829,45.4867077732,50.5407864146,5.0540786415
2912301,Ibicuí,8,Médio Sudoeste da Bahia,16796,7,3,13,0,23,10,13,20,3,136.9373660395,59.5379852346,77.399380805,119.0759704692,17.8613955704
2912400,Ibipeba,1,Irecê,18678,5,0,13,0,18,5,13,18,0,96.3700610344,26.7694613984,69.6005996359,96.3700610344,0
2912509,Ibipitanga,12,Bacia do Paramirim,15413,8,1,7,0,16,9,7,15,1,103.8084733666,58.3922662687,45.4162070979,97.3204437812,6.4880295854
2912608,Ibiquera,14,Piemonte do Paraguaçu,4214,9,0,3,0,12,9,3,12,0,284.7650688182,213.5738016137,71.1912672046,284.7650688182,0
2912707,Ibirapitanga,6,Baixo Sul,24293,2,1,13,0,16,3,13,15,1,65.8625941629,12.3492364055,53.5133577574,61.7461820277,4.1164121352
2912806,Ibirapoã,7,Extremo Sul,8852,20,0,6,0,26,20,6,26,0,293.7189335743,225.937641211,67.7812923633,293.7189335743,0
2912905,Ibirataia,22,Médio Rio de Contas,17221,6,0,19,0,25,6,19,25,0,145.1715928227,34.8411822775,110.3304105453,145.1715928227,0
2913002,Ibitiara,3,Chapada Diamantina,16855,5,0,9,0,14,5,9,14,0,83.0614061109,29.6647878968,53.3966182142,83.0614061109,0
2913101,Ibititá,1,Irecê,17948,9,0,10,0,19,9,10,19,0,105.8613773122,50.1448629374,55.7165143749,105.8613773122,0
2913200,Ibotirama,2,Velho Chico,27862,11,5,32,0,48,16,32,43,5,172.2776541526,57.4258847175,114.8517694351,154.3320651784,17.9455889742
2913309,Ichu,4,Sisal,6437,209,0,6,0,215,209,6,215,0,3340.0652477862,3246.8541245922,93.211123194,3340.0652477862,0
2913408,Igaporã,2,Velho Chico,16283,13,0,11,0,24,13,11,24,0,147.3929865504,79.8378677148,67.5551188356,147.3929865504,0
2913457,Igrapiúna,6,Baixo Sul,14187,7,0,12,0,19,7,12,19,0,133.9254246846,49.3409459364,84.5844787481,133.9254246846,0
2913507,Iguaí,8,Médio Sudoeste da Bahia,27939,36,0,12,0,48,36,12,48,0,171.8028562225,128.8521421669,42.9507140556,171.8028562225,0
2913606,Ilhéus,5,Litoral Sul,176341,32,49,200,10,291,81,210,232,59,165.0211805536,45.9337306696,119.087449884,131.5632779671,33.4579025865
2913705,Inhambupe,18,Litoral Norte e Agreste Baiano,40453,2,0,16,0,18,2,16,18,0,44.4960818728,4.944009097,39.5520727758,44.4960818728,0
2913804,Ipecaetá,19,Portal do Sertão,15499,3,0,9,0,12,3,9,12,0,77.4243499581,19.3560874895,58.0682624685,77.4243499581,0
2913903,Ipiaú,22,Médio Rio de Contas,47704,6,6,40,1,53,12,41,46,7,111.1017943988,25.1551232601,85.9466711387,96.4279724971,14.6738219017
2914000,Ipirá,15,Bacia do Jacuípe,62631,8,5,24,2,39,13,26,32,7,62.2694831633,20.7564943878,41.5129887755,51.0929092622,11.1765739011
2914109,Ipupiara,1,Irecê,10157,4,0,11,0,15,4,11,15,0,147.6814019888,39.381707197,108.2996947918,147.6814019888,0
2914208,Irajuba,9,Vale do Jiquiriçá,7521,125,0,6,0,131,125,6,131,0,1741.7896556309,1662.0130301822,79.7766254487,1741.7896556309,0
2914307,Iramaia,3,Chapada Diamantina,9901,12,0,8,0,20,12,8,20,0,201.9997980002,121.1998788001,80.7999192001,201.9997980002,0
2914406,Iraquara,3,Chapada Diamantina,25536,28,0,4,0,32,28,4,32,0,125.313283208,109.649122807,15.664160401,125.313283208,0
2914505,Irará,19,Portal do Sertão,29879,339,4,6,0,349,343,6,345,4,1168.0444459319,1147.9634525921,20.0809933398,1154.6571170387,13.3873288932
2914604,Irecê,1,Irecê,74483,12,7,89,1,109,19,90,101,8,146.3421183357,25.5091765906,120.8329417451,135.6014124028,10.7407059329
2914653,Itabela,27,Costa do Descobrimento,31422,4,1,31,0,36,5,31,35,1,114.5694099675,15.912418051,98.6569919165,111.3869263573,3.1824836102
2914703,Itaberaba,14,Piemonte do Paraguaçu,66806,3,13,51,4,71,16,55,54,17,106.2778792324,23.9499446158,82.3279346167,80.8310630782,25.4468161542
2914802,Itabuna,5,Litoral Sul,221046,6,41,335,24,406,47,359,341,65,183.672176832,21.2625426382,162.4096341938,154.2665327579,29.4056440741
2914901,Itacaré,5,Litoral Sul,28382,1,0,19,0,20,1,19,20,0,70.4671975196,3.523359876,66.9438376436,70.4671975196,0
2915007,Itaetê,3,Chapada Diamantina,16586,10,0,10,0,20,10,10,20,0,120.5836247438,60.2918123719,60.2918123719,120.5836247438,0
2915106,Itagi,22,Médio Rio de Contas,13199,4,0,8,0,12,4,8,12,0,90.9159784832,30.3053261611,60.6106523221,90.9159784832,0
2915205,Itagibá,22,Médio Rio de Contas,15577,7,0,9,0,16,7,9,16,0,102.7155421455,44.9380496886,57.7774924568,102.7155421455,0
2915304,Itagimirim,27,Costa do Descobrimento,7291,41,0,4,0,45,41,4,45,0,617.1992867919,562.337127966,54.8621588259,617.1992867919,0
2915353,Itaguaçu da Bahia,1,Irecê,14718,3,0,7,0,10,3,7,10,0,67.9440141324,20.3832042397,47.5608098926,67.9440141324,0
2915403,Itaju do Colônia,5,Litoral Sul,7218,9,0,6,0,15,9,6,15,0,207.8137988362,124.6882793017,83.1255195345,207.8137988362,0
2915502,Itajuípe,5,Litoral Sul,21642,1,0,12,0,13,1,12,13,0,60.0683855466,4.620645042,55.4477405046,60.0683855466,0
2915601,Itamaraju,7,Extremo Sul,67356,9,9,71,3,92,18,74,80,12,136.5876833541,26.723677178,109.8640061761,118.7718985688,17.8157847853
2915700,Itamari,22,Médio Rio de Contas,8476,18,0,11,0,29,18,11,29,0,342.1425200566,212.3643227938,129.7781972629,342.1425200566,0
2915809,Itambé,8,Médio Sudoeste da Bahia,24901,4,0,15,0,19,4,15,19,0,76.3021565399,16.0636119031,60.2385446368,76.3021565399,0
2915908,Itanagra,18,Litoral Norte e Agreste Baiano,6730,9,0,4,0,13,9,4,13,0,193.1649331352,133.7295690936,59.4353640416,193.1649331352,0
2916005,Itanhém,7,Extremo Sul,20501,44,2,18,0,64,46,18,62,2,312.1798936637,224.3792985708,87.8005950929,302.4242719867,9.755621677
2916104,Itaparica,26,Metropolitano de Salvador,22866,19,1,29,0,49,20,29,48,1,214.2919618648,87.4661068836,126.8258549812,209.9186565206,4.3733053442
2916203,Itapé,5,Litoral Sul,9830,2,0,12,0,14,2,12,14,0,142.4211597152,20.3458799593,122.0752797559,142.4211597152,0
2916302,Itapebi,27,Costa do Descobrimento,10830,7,0,11,0,18,7,11,18,0,166.2049861496,64.6352723915,101.5697137581,166.2049861496,0
2916401,Itapetinga,8,Médio Sudoeste da Bahia,77533,5,27,59,0,91,32,59,64,27,117.3693782003,41.2727483781,76.0966298221,82.5454967562,34.823881444
2916500,Itapicuru,18,Litoral Norte e Agreste Baiano,36211,9,0,21,0,30,9,21,30,0,82.8477534451,24.8543260335,57.9934274116,82.8477534451,0
2916609,Itapitanga,5,Litoral Sul,10799,5,0,7,0,12,5,7,12,0,111.1214001296,46.3005833874,64.8208167423,111.1214001296,0
2916708,Itaquara,9,Vale do Jiquiriçá,8592,13,0,7,0,20,13,7,20,0,232.7746741155,151.303538175,81.4711359404,232.7746741155,0
2916807,Itarantim,8,Médio Sudoeste da Bahia,20314,4,1,15,0,20,5,15,19,1,98.4542679925,24.6135669981,73.8407009944,93.5315545929,4.9227133996
2916856,Itatim,14,Piemonte do Paraguaçu,14957,9,0,15,0,24,9,15,24,0,160.4599852912,60.1724944842,100.287490807,160.4599852912,0
2916906,Itiruçu,9,Vale do Jiquiriçá,13254,8,0,11,0,19,8,11,19,0,143.3529500528,60.3591368643,82.9938131885,143.3529500528,0
2917003,Itiúba,4,Sisal,37567,5,1,1,0,7,6,1,6,1,18.6333750366,15.9714643171,2.6619107195,15.9714643171,2.6619107195
2917102,Itororó,8,Médio Sudoeste da Bahia,21241,5,1,17,0,23,6,17,22,1,108.2811543713,28.2472576621,80.0338967092,103.5732780943,4.707876277
2917201,Ituaçu,13,Sertão Produtivo,19577,5,0,14,0,19,5,14,19,0,97.0526638402,25.5401746948,71.5124891454,97.0526638402,0
2917300,Ituberá,6,Baixo Sul,29428,37,2,12,2,53,39,14,49,4,180.1005844774,132.5268451815,47.5737392959,166.5080875357,13.5924969417
2917334,Iuiu,13,Sertão Produtivo,11399,18,0,5,0,23,18,5,23,0,201.7720852706,157.9085884727,43.863496798,201.7720852706,0
2917359,Jaborandi,23,Bacia do Rio Corrente,9056,15,0,15,0,30,15,15,30,0,331.2720848057,165.6360424028,165.6360424028,331.2720848057,0
2917409,Jacaraci,20,Sudoeste Baiano,15459,4,0,15,0,19,4,15,19,0,122.9057506954,25.8748948832,97.0308558121,122.9057506954,0
2917508,Jacobina,16,Piemonte da Diamantina,83635,1,39,59,4,103,40,63,60,43,123.1541818617,47.8268667424,75.3273151193,71.7403001136,51.4138817481
2917607,Jaguaquara,9,Vale do Jiquiriçá,56033,136,8,40,1,185,144,41,176,9,330.1625827637,256.9914157728,73.1711669909,314.1006192779,16.0619634858
2917706,Jaguarari,25,Piemonte Norte do Itapicuru,34499,20,1,9,3,33,21,12,29,4,95.6549465202,60.8713296038,34.7836169164,84.060407548,11.5945389721
2917805,Jaguaripe,6,Baixo Sul,19036,6,0,7,0,13,6,7,13,0,68.2916579113,31.5192267283,36.772431183,68.2916579113,0
2917904,Jandaíra,18,Litoral Norte e Agreste Baiano,11120,5,0,3,0,8,5,3,8,0,71.9424460432,44.964028777,26.9784172662,71.9424460432,0
2918001,Jequié,22,Médio Rio de Contas,162209,4,59,238,15,316,63,253,242,74,194.8103989298,38.8387820651,155.9716168647,149.1902422184,45.6201567114
2918100,Jeremoabo,17,Semiárido Nordeste II,41605,314,1,41,0,356,315,41,355,1,855.6663862517,757.1205383968,98.5458478548,853.2628289869,2.4035572648
2918209,Jiquiriçá,9,Vale do Jiquiriçá,15106,4,0,8,0,12,4,8,12,0,79.4386336555,26.4795445518,52.9590891037,79.4386336555,0
2918308,Jitaúna,22,Médio Rio de Contas,12692,5,0,12,0,17,5,12,17,0,133.9426410337,39.3948944217,94.547746612,133.9426410337,0
2918357,João Dourado,1,Irecê,25646,2,1,9,0,12,3,9,11,1,46.790922561,11.6977306403,35.0931919208,42.8916790143,3.8992435468
2918407,Juazeiro,10,Sertão do São Francisco,221773,4,79,266,1,350,83,267,270,80,157.8190311715,37.4256559635,120.393375208,121.7461097609,36.0729214106
2918456,Jucuruçu,7,Extremo Sul,9924,3,0,9,0,12,3,9,12,0,120.9189842805,30.2297460701,90.6892382104,120.9189842805,0
2918506,Jussara,1,Irecê,16006,4,0,12,0,16,4,12,16,0,99.9625140572,24.9906285143,74.9718855429,99.9625140572,0
2918555,Jussari,5,Litoral Sul,6275,14,0,7,0,21,14,7,21,0,334.6613545817,223.1075697211,111.5537848606,334.6613545817,0
2918605,Jussiape,3,Chapada Diamantina,7066,4,0,9,0,13,4,9,13,0,183.9796207189,56.6091140674,127.3705066516,183.9796207189,0
2918704,Lafayette Coutinho,9,Vale do Jiquiriçá,3975,0,0,8,0,8,0,8,8,0,201.2578616352,0,201.2578616352,201.2578616352,0
2918753,Lagoa Real,13,Sertão Produtivo,16029,4,0,6,0,10,4,6,10,0,62.3869237008,24.9547694803,37.4321542205,62.3869237008,0
2918803,Laje,9,Vale do Jiquiriçá,24306,3,1,12,0,16,4,12,15,1,65.8273677281,16.456841932,49.3705257961,61.7131572451,4.114210483
2918902,Lajedão,7,Extremo Sul,4068,11,0,12,0,23,11,12,23,0,565.3883972468,270.4031465093,294.9852507375,565.3883972468,0
2919009,Lajedinho,14,Piemonte do Paraguaçu,4017,254,0,0,0,254,254,0,254,0,6323.1267114762,6323.1267114762,0,6323.1267114762,0
2919058,Lajedo do Tabocal,9,Vale do Jiquiriçá,8886,4,0,6,0,10,4,6,10,0,112.5365743867,45.0146297547,67.521944632,112.5365743867,0
2919108,Lamarão,4,Sisal,9007,3,0,7,0,10,3,7,10,0,111.0247585212,33.3074275563,77.7173309648,111.0247585212,0
2919157,Lapão,1,Irecê,28244,22,0,23,0,45,22,23,45,0,159.325874522,77.8926497663,81.4332247557,159.325874522,0
2919207,Lauro de Freitas,26,Metropolitano de Salvador,197636,51,231,144,12,438,282,156,195,243,221.6195429982,142.6865550811,78.9329879172,98.6662348965,122.9533081018
2919306,Lençóis,3,Chapada Diamantina,11636,7,0,7,0,14,7,7,14,0,120.3162598831,60.1581299416,60.1581299416,120.3162598831,0
2919405,Licínio de Almeida,20,Sudoeste Baiano,12969,3,0,12,0,15,3,12,15,0,115.6604210039,23.1320842008,92.5283368031,115.6604210039,0
2919504,Livramento de Nossa Senhora,13,Sertão Produtivo,46739,24,7,29,5,65,31,34,53,12,139.0701555446,66.3257664905,72.7443890541,113.3956652902,25.6744902544
2919553,Luís Eduardo Magalhães,11,Bacia do Rio Grande,83557,7,11,49,1,68,18,50,56,12,81.3815718611,21.5421807868,59.8393910744,67.0201180033,14.3614538578
2919603,Macajuba,14,Piemonte do Paraguaçu,11879,35,0,7,0,42,35,7,42,0,353.5651149087,294.6375957572,58.9275191514,353.5651149087,0
2919702,Macarani,8,Médio Sudoeste da Bahia,19110,8,0,15,0,23,8,15,23,0,120.3558346415,41.8628990058,78.4929356358,120.3558346415,0
2919801,Macaúbas,12,Bacia do Paramirim,50987,3,1,34,0,38,4,34,37,1,74.5288014592,7.8451369957,66.6836644635,72.5675172103,1.9612842489
2919900,Macururé,24,Itaparica,8266,8,0,7,0,15,8,7,15,0,181.466247278,96.7819985483,84.6842487297,181.466247278,0
2919926,Madre de Deus,26,Metropolitano de Salvador,21007,4,0,22,1,27,4,23,26,1,128.5285857095,19.041271957,109.4873137526,123.7682677203,4.7603179892
2919959,Maetinga,20,Sudoeste Baiano,4456,2,1,11,0,14,3,11,13,1,314.1831238779,67.3249551167,246.8581687612,291.7414721724,22.4416517056
2920007,Maiquinique,8,Médio Sudoeste da Bahia,10274,4,0,7,0,11,4,7,11,0,107.0663811563,38.9332295114,68.1331516449,107.0663811563,0
2920106,Mairi,15,Bacia do Jacuípe,19695,5,1,23,0,29,6,23,28,1,147.2454937801,30.46458492,116.7809088601,142.1680629601,5.07743082
2920205,Malhada,2,Velho Chico,17526,8,0,7,0,15,8,7,15,0,85.587127696,45.6464681045,39.9406595915,85.587127696,0
2920304,Malhada de Pedras,13,Sertão Produtivo,8856,13,0,4,0,17,13,4,17,0,191.9602529359,146.793134598,45.1671183379,191.9602529359,0
2920403,Manoel Vitorino,22,Médio Rio de Contas,14251,8,0,13,0,21,8,13,21,0,147.3580801347,56.1364114799,91.2216686548,147.3580801347,0
2920452,Mansidão,11,Bacia do Rio Grande,13959,1,0,3,0,4,1,3,4,0,28.6553478043,7.1638369511,21.4915108532,28.6553478043,0
2920502,Maracás,9,Vale do Jiquiriçá,23018,5,0,15,0,20,5,15,20,0,86.8885220262,21.7221305066,65.1663915197,86.8885220262,0
2920601,Maragogipe,21,Recôncavo,46260,34,1,22,0,57,35,22,56,1,123.2166018158,75.6593169045,47.5572849114,121.0549070471,2.1616947687
2920700,Maraú,5,Litoral Sul,21313,4,0,14,0,18,4,14,18,0,84.4554966452,18.7678881434,65.6876085019,84.4554966452,0
2920809,Marcionílio Souza,3,Chapada Diamantina,10931,20,0,6,0,26,20,6,26,0,237.8556399232,182.965876864,54.8897630592,237.8556399232,0
2920908,Mascote,5,Litoral Sul,14728,12,0,9,0,21,12,9,21,0,142.5855513308,81.4774579033,61.1080934275,142.5855513308,0
2921005,Mata de São João,26,Metropolitano de Salvador,46998,3,3,23,1,30,6,24,26,4,63.8325035108,12.7665007022,51.0660028086,55.3215030427,8.5110004681
2921054,Matina,2,Velho Chico,12488,3,0,6,0,9,3,6,9,0,72.069186419,24.0230621397,48.0461242793,72.069186419,0
2921104,Medeiros Neto,7,Extremo Sul,23586,3,0,18,0,21,3,18,21,0,89.0358687357,12.7194098194,76.3164589163,89.0358687357,0
2921203,Miguel Calmon,16,Piemonte da Diamantina,27520,20,2,20,0,42,22,20,40,2,152.6162790698,79.9418604651,72.6744186047,145.3488372093,7.2674418605
2921302,Milagres,9,Vale do Jiquiriçá,11585,4,0,5,0,9,4,5,9,0,77.6866637894,34.5274061286,43.1592576608,77.6866637894,0
2921401,Mirangaba,16,Piemonte da Diamantina,18729,20,0,10,0,30,20,10,30,0,160.179400929,106.786267286,53.393133643,160.179400929,0
2921450,Mirante,20,Sudoeste Baiano,9578,7,0,5,0,12,7,5,12,0,125.2871163082,73.0841511798,52.2029651284,125.2871163082,0
2921500,Monte Santo,4,Sisal,51953,4,0,22,0,26,4,22,26,0,50.0452331915,7.6992666449,42.3459665467,50.0452331915,0
2921609,Morpará,2,Velho Chico,8950,27,0,9,0,36,27,9,36,0,402.2346368715,301.6759776536,100.5586592179,402.2346368715,0
2921708,Morro do Chapéu,3,Chapada Diamantina,36856,5,0,32,0,37,5,32,37,0,100.3907097895,13.5663121337,86.8243976557,100.3907097895,0
2921807,Mortugaba,20,Sudoeste Baiano,12529,9,0,12,0,21,9,12,21,0,167.6111421502,71.8333466358,95.7777955144,167.6111421502,0
2921906,Mucugê,3,Chapada Diamantina,9957,4,0,9,0,13,4,9,13,0,130.5614140805,40.172742794,90.3886712865,130.5614140805,0
2922003,Mucuri,7,Extremo Sul,42072,3,9,22,0,34,12,22,25,9,80.8138429359,28.5225328009,52.291310135,59.4219433352,21.3918996007
2922052,Mulungu do Morro,1,Irecê,11988,13,0,9,0,22,13,9,22,0,183.5168501835,108.4417751084,75.0750750751,183.5168501835,0
2922102,Mundo Novo,14,Piemonte do Paraguaçu,27364,7,0,11,0,18,7,11,18,0,65.7798567461,25.5810554013,40.1988013448,65.7798567461,0
2922201,Muniz Ferreira,21,Recôncavo,7678,17,0,6,0,23,17,6,23,0,299.557176348,221.4118259964,78.1453503517,299.557176348,0
2922250,Muquém do São Francisco,2,Velho Chico,11644,5,0,8,0,13,5,8,13,0,111.645482652,42.9405702508,68.7049124012,111.645482652,0
2922300,Muritiba,21,Recôncavo,30631,7,4,20,0,31,11,20,27,4,101.2046619438,35.9113316575,65.2933302863,88.1459958865,13.0586660573
2922409,Mutuípe,9,Vale do Jiquiriçá,22998,10,2,17,0,29,12,17,27,2,126.0979215584,52.1784503,73.9194712584,117.4015131751,8.6964083833
2922508,Nazaré,21,Recôncavo,29546,2,3,21,0,26,5,21,23,3,87.9983754146,16.9227645028,71.0756109118,77.8447167129,10.1536587017
2922607,Nilo Peçanha,6,Baixo Sul,14368,1,0,9,0,10,1,9,10,0,69.5991091314,6.9599109131,62.6391982183,69.5991091314,0
2922656,Nordestina,4,Sisal,13597,4,0,12,0,16,4,12,16,0,117.6730161065,29.4182540266,88.2547620799,117.6730161065,0
2922706,Nova Canaã,8,Médio Sudoeste da Bahia,17141,3,0,11,0,14,3,11,14,0,81.6755148474,17.5018960387,64.1736188087,81.6755148474,0
2922730,Nova Fátima,15,Bacia do Jacuípe,8119,6,1,7,0,14,7,7,13,1,172.4350289445,86.2175144722,86.2175144722,160.1182411627,12.3167877817
2922755,Nova Ibiá,22,Médio Rio de Contas,6986,27,0,6,0,33,27,6,33,0,472.3733180647,386.4872602348,85.8860578299,472.3733180647,0
2922805,Nova Itarana,9,Vale do Jiquiriçá,8428,2,0,4,0,6,2,4,6,0,71.1912672046,23.7304224015,47.460844803,71.1912672046,0
2922854,Nova Redenção,3,Chapada Diamantina,9500,6,0,4,0,10,6,4,10,0,105.2631578947,63.1578947368,42.1052631579,105.2631578947,0
2922904,Nova Soure,17,Semiárido Nordeste II,25460,11,1,9,0,21,12,9,20,1,82.482325216,47.1327572663,35.3495679497,78.5545954438,3.9277297722
2923001,Nova Viçosa,7,Extremo Sul,44052,6,0,19,0,25,6,19,25,0,56.7511123218,13.6202669572,43.1308453646,56.7511123218,0
2923035,Novo Horizonte,3,Chapada Diamantina,12514,3,0,5,0,8,3,5,8,0,63.9284001918,23.9731500719,39.9552501199,63.9284001918,0
2923050,Novo Triunfo,17,Semiárido Nordeste II,16037,12,0,5,0,17,12,5,17,0,106.0048637526,74.8269626489,31.1779011037,106.0048637526,0
2923100,Olindina,18,Litoral Norte e Agreste Baiano,29227,6,1,13,0,20,7,13,19,1,68.4298764841,23.9504567694,44.4794197146,65.0083826599,3.4214938242
2923209,Oliveira dos Brejinhos,2,Velho Chico,22805,6,1,12,0,19,7,12,18,1,83.3150624863,30.6950230213,52.620039465,78.9300591975,4.3850032888
2923308,Ouriçangas,18,Litoral Norte e Agreste Baiano,8916,19,0,3,0,22,19,3,22,0,246.7474203679,213.1000448632,33.6473755047,246.7474203679,0
2923357,Ourolândia,16,Piemonte da Diamantina,18025,7,1,12,1,21,8,13,19,2,116.5048543689,44.3828016644,72.1220527046,105.4091539528,11.0957004161
2923407,Palmas de Monte Alto,13,Sertão Produtivo,22553,12,0,11,0,23,12,11,23,0,101.9819979604,53.2079989358,48.7739990245,101.9819979604,0
2923506,Palmeiras,3,Chapada Diamantina,9250,5,0,9,0,14,5,9,14,0,151.3513513514,54.0540540541,97.2972972973,151.3513513514,0
2923605,Paramirim,12,Bacia do Paramirim,22286,96,3,32,4,135,99,36,128,7,605.7614645966,444.2250740375,161.5363905591,574.3516108768,31.4098537198
2923704,Paratinga,2,Velho Chico,32967,9,0,12,0,21,9,12,21,0,63.7000637001,27.3000273,36.4000364,63.7000637001,0
2923803,Paripiranga,17,Semiárido Nordeste II,30075,3,0,10,0,13,3,10,13,0,43.2252701579,9.9750623441,33.2502078138,43.2252701579,0
2923902,Pau-Brasil,5,Litoral Sul,10673,6,0,11,0,17,6,11,17,0,159.2804272463,56.2166213811,103.0638058653,159.2804272463,0
2924009,Paulo Afonso,24,Itaparica,120706,8,47,90,2,147,55,92,98,49,121.7835070336,45.5652577337,76.2182493,81.1890046891,40.5945023445
2924058,Pé de Serra,15,Bacia do Jacuípe,14226,6,0,11,0,17,6,11,17,0,119.4995079432,42.1762969211,77.3232110221,119.4995079432,0
2924108,Pedrão,18,Litoral Norte e Agreste Baiano,7527,3,0,3,0,6,3,3,6,0,79.7130330809,39.8565165405,39.8565165405,79.7130330809,0
2924207,Pedro Alexandre,17,Semiárido Nordeste II,18209,13,0,9,0,22,13,9,22,0,120.8193750343,71.3932670657,49.4261079686,120.8193750343,0
2924306,Piatã,3,Chapada Diamantina,18267,2,0,11,0,13,2,11,13,0,71.1665845514,10.9487053156,60.2178792358,71.1665845514,0
2924405,Pilão Arcado,10,Sertão do São Francisco,35740,3,0,11,0,14,3,11,14,0,39.1717963067,8.3939563514,30.7778399552,39.1717963067,0
2924504,Pindaí,13,Sertão Produtivo,16889,3,0,7,0,10,3,7,10,0,59.2101367754,17.7630410326,41.4470957428,59.2101367754,0
2924603,Pindobaçu,25,Piemonte Norte do Itapicuru,21171,8,0,3,0,11,8,3,11,0,51.9578668934,37.7875395588,14.1703273346,51.9578668934,0
2924652,Pintadas,15,Bacia do Jacuípe,11012,3,0,4,0,7,3,4,7,0,63.5670177988,27.243007628,36.3240101707,63.5670177988,0
2924678,Piraí do Norte,6,Baixo Sul,10411,8,0,6,0,14,8,6,14,0,134.4731533954,76.8418019403,57.6313514552,134.4731533954,0
2924702,Piripá,20,Sudoeste Baiano,11849,20,0,16,0,36,20,16,36,0,303.8231074352,168.7906152418,135.0324921934,303.8231074352,0
2924801,Piritiba,14,Piemonte do Paraguaçu,25211,24,0,6,0,30,24,6,30,0,118.9956764904,95.1965411923,23.7991352981,118.9956764904,0
2924900,Planaltino,9,Vale do Jiquiriçá,9582,1,0,7,0,8,1,7,8,0,83.4898768524,10.4362346066,73.0536422459,83.4898768524,0
2925006,Planalto,20,Sudoeste Baiano,26915,93,0,21,0,114,93,21,114,0,423.55563812,345.5322310979,78.0234070221,423.55563812,0
2925105,Poções,20,Sudoeste Baiano,48861,3,8,37,0,48,11,37,40,8,98.2378584147,22.5128425534,75.7250158613,81.8648820122,16.3729764024
2925204,Pojuca,26,Metropolitano de Salvador,39718,7,6,26,1,40,13,27,33,7,100.7100055391,32.7307518002,67.9792537389,83.0857545697,17.6242509693
2925253,Ponto Novo,25,Piemonte Norte do Itapicuru,15830,6,0,10,0,16,6,10,16,0,101.0739102969,37.9027163613,63.1711939356,101.0739102969,0
2925303,Porto Seguro,27,Costa do Descobrimento,149324,5,29,151,1,186,34,152,156,30,124.5613565134,22.7692802229,101.7920762905,104.4708151402,20.0905413731
2925402,Potiraguá,8,Médio Sudoeste da Bahia,8438,7,0,6,0,13,7,6,13,0,154.0649442996,82.9580469306,71.106897369,154.0649442996,0
2925501,Prado,7,Extremo Sul,29326,3,1,24,0,28,4,24,27,1,95.4784150583,13.6397735798,81.8386414786,92.0684716634,3.4099433949
2925600,Presidente Dutra,1,Irecê,15734,11,0,11,0,22,11,11,22,0,139.8245837041,69.912291852,69.912291852,139.8245837041,0
2925709,Presidente Jânio Quadros,20,Sudoeste Baiano,13334,4,1,14,0,19,5,14,18,1,142.4928753562,37.4981250937,104.9947502625,134.9932503375,7.4996250187
2925758,Presidente Tancredo Neves,6,Baixo Sul,28082,6,4,15,0,25,10,15,21,4,89.0249982195,35.6099992878,53.4149989317,74.7809985044,14.2439997151
2925808,Queimadas,4,Sisal,26552,24,1,11,0,36,25,11,35,1,135.5830069298,94.1548659235,41.4281410063,131.8168122929,3.7661946369
2925907,Quijingue,4,Sisal,28632,7,0,16,0,23,7,16,23,0,80.3297010338,24.4481698799,55.881531154,80.3297010338,0
2925931,Quixabeira,15,Bacia do Jacuípe,9411,7,0,6,0,13,7,6,13,0,138.1362235682,74.3810434598,63.7551801084,138.1362235682,0
2925956,Rafael Jambeiro,14,Piemonte do Paraguaçu,23562,15,0,21,0,36,15,21,36,0,152.7883880825,63.6618283677,89.1265597148,152.7883880825,0
2926004,Remanso,10,Sertão do São Francisco,42672,11,0,21,0,32,11,21,32,0,74.9906261717,25.7780277465,49.2125984252,74.9906261717,0
2926103,Retirolândia,4,Sisal,14730,3,0,4,0,7,3,4,7,0,47.5220638153,20.366598778,27.1554650373,47.5220638153,0
2926202,Riachão das Neves,11,Bacia do Rio Grande,23313,24,0,15,0,39,24,15,39,0,167.288637241,102.9468536868,64.3417835542,167.288637241,0
2926301,Riachão do Jacuípe,15,Bacia do Jacuípe,34784,3,1,26,0,30,4,26,29,1,86.246550138,11.4995400184,74.7470101196,83.3716651334,2.8748850046
2926400,Riacho de Santana,2,Velho Chico,36439,2,0,23,0,25,2,23,25,0,68.6078103131,5.4886248251,63.1191854881,68.6078103131,0
2926509,Ribeira do Amparo,17,Semiárido Nordeste II,15443,3,0,8,0,11,3,8,11,0,71.2296833517,19.4262772777,51.8034060739,71.2296833517,0
2926608,Ribeira do Pombal,17,Semiárido Nordeste II,54965,5,6,43,3,57,11,46,48,9,103.7023560448,20.0127353771,83.6896206677,87.3282998272,16.3740562176
2926657,Ribeirão do Largo,20,Sudoeste Baiano,7437,10,0,7,0,17,10,7,17,0,228.586795751,134.46282103,94.123974721,228.586795751,0
2926707,Rio de Contas,3,Chapada Diamantina,13712,5,0,7,0,12,5,7,12,0,87.5145857643,36.4644107351,51.0501750292,87.5145857643,0
2926806,Rio do Antônio,13,Sertão Produtivo,15804,17,0,5,0,22,17,5,22,0,139.20526449,107.5677043786,31.6375601114,139.20526449,0
2926905,Rio do Pires,12,Bacia do Paramirim,12130,4,0,5,0,9,4,5,9,0,74.1962077494,32.9760923331,41.2201154163,74.1962077494,0
2927002,Rio Real,18,Litoral Norte e Agreste Baiano,41767,6130,0,21,0,6151,6130,21,6151,0,14726.9375344171,14676.6586060766,50.2789283406,14726.9375344171,0
2927101,Rodelas,24,Itaparica,9405,3,0,4,0,7,3,4,7,0,74.4284954811,31.8979266348,42.5305688464,74.4284954811,0
2927200,Ruy Barbosa,14,Piemonte do Paraguaçu,32009,3,1,17,0,21,4,17,20,1,65.6065481583,12.4964853635,53.1100627948,62.4824268175,3.1241213409
2927309,Salinas da Margarida,21,Recôncavo,15772,17,0,11,0,28,17,11,28,0,177.5297996449,107.7859497844,69.7438498605,177.5297996449,0
2927408,Salvador,26,Metropolitano de Salvador,2953986,1,1442,4443,477,6363,1443,4920,4444,1919,215.4038644733,48.8492497933,166.55461468,150.4407942353,64.963070238
2927507,Santa Bárbara,19,Portal do Sertão,21415,2,2,10,0,14,4,10,12,2,65.3747373336,18.678496381,46.6962409526,56.0354891431,9.3392481905
2927606,Santa Brígida,17,Semiárido Nordeste II,14976,23,0,7,0,30,23,7,30,0,200.3205128205,153.5790598291,46.7414529915,200.3205128205,0
2927705,Santa Cruz Cabrália,27,Costa do Descobrimento,28552,1,0,18,0,19,1,18,19,0,66.5452507705,3.5023816195,63.042869151,66.5452507705,0
2927804,Santa Cruz da Vitória,8,Médio Sudoeste da Bahia,6698,27,0,5,0,32,27,5,32,0,477.7545535981,403.1054045984,74.6491489997,477.7545535981,0
2927903,Santa Inês,9,Vale do Jiquiriçá,11161,10,0,7,0,17,10,7,17,0,152.3161007078,89.5977062987,62.7183944091,152.3161007078,0
2928000,Santaluz,4,Sisal,38422,3,0,25,0,28,3,25,28,0,72.874915413,7.8080266514,65.0668887616,72.874915413,0
2928059,Santa Luzia,5,Litoral Sul,13398,11,0,9,0,20,11,9,20,0,149.276011345,82.1018062397,67.1742051052,149.276011345,0
2928109,Santa Maria da Vitória,23,Bacia do Rio Corrente,41769,4,1,32,0,37,5,32,36,1,88.5824415236,11.9706002059,76.6118413177,86.1883214824,2.3941200412
2928208,Santana,23,Bacia do Rio Corrente,27492,27,0,10,0,37,27,10,37,0,134.584606431,98.2103884766,36.3742179543,134.584606431,0
2928307,Santanópolis,19,Portal do Sertão,9263,85,0,5,0,90,85,5,90,0,971.6074705819,917.6292777718,53.9781928101,971.6074705819,0
2928406,Santa Rita de Cássia,11,Bacia do Rio Grande,29146,21,0,24,0,45,21,24,45,0,154.3951142524,72.0510533178,82.3440609346,154.3951142524,0
2928505,Santa Terezinha,14,Piemonte do Paraguaçu,10682,6,0,7,0,13,6,7,13,0,121.7000561693,56.1692566935,65.5307994758,121.7000561693,0
2928604,Santo Amaro,21,Recôncavo,61961,3,4,37,0,44,7,37,40,4,71.0124110327,11.2974290279,59.7149820048,64.5567373025,6.4556737302
2928703,Santo Antônio de Jesus,21,Recôncavo,103342,22,29,85,24,160,51,109,107,53,154.8257242941,49.3506996187,105.4750246754,103.5397031217,51.2860211724
2928802,Santo Estevão,19,Portal do Sertão,53898,8,2,29,0,39,10,29,37,2,72.3589001447,18.5535641397,53.805336005,68.6481873168,3.7107128279
2928901,São Desidério,11,Bacia do Rio Grande,33661,9,0,18,0,27,9,18,27,0,80.211520751,26.7371735837,53.4743471673,80.211520751,0
2928950,São Domingos,4,Sisal,9404,31,0,6,0,37,31,6,37,0,393.4495959166,329.646958741,63.8026371757,393.4495959166,0
2929008,São Félix,21,Recôncavo,15310,6,0,21,0,27,6,21,27,0,176.3553233181,39.1900718485,137.1652514696,176.3553233181,0
2929057,São Félix do Coribe,23,Bacia do Rio Corrente,15825,9,0,14,0,23,9,14,23,0,145.3396524487,56.8720379147,88.467614534,145.3396524487,0
2929107,São Felipe,21,Recôncavo,21964,2,1,17,0,20,3,17,19,1,91.0580950647,13.6587142597,77.399380805,86.5051903114,4.5529047532
2929206,São Francisco do Conde,26,Metropolitano de Salvador,40220,3,1,50,0,54,4,50,53,1,134.2615614122,9.9453008454,124.3162605669,131.7752362009,2.4863252113
2929255,São Gabriel,1,Irecê,19613,2,0,9,0,11,2,9,11,0,56.0852495794,10.1973181053,45.887931474,56.0852495794,0
2929305,São Gonçalo dos Campos,19,Portal do Sertão,38018,21,2,16,0,39,23,16,37,2,102.5829870062,60.4976590036,42.0853280025,97.3223210058,5.2606660003
2929354,São José da Vitória,5,Litoral Sul,6045,3,0,5,0,8,3,5,8,0,132.3407775021,49.6277915633,82.7129859388,132.3407775021,0
2929370,São José do Jacuípe,15,Bacia do Jacuípe,10784,9,0,5,0,14,9,5,14,0,129.821958457,83.4569732938,46.3649851632,129.821958457,0
2929404,São Miguel das Matas,9,Vale do Jiquiriçá,12092,3,0,7,0,10,3,7,10,0,82.6993053258,24.8097915978,57.8895137281,82.6993053258,0
2929503,São Sebastião do Passé,26,Metropolitano de Salvador,45827,3,3,26,0,32,6,26,29,3,69.8278307548,13.0927182665,56.7351124883,63.2814716215,6.5463591333
2929602,Sapeaçu,21,Recôncavo,18114,13,0,22,0,35,13,22,35,0,193.2207132605,71.7676934967,121.4530197637,193.2207132605,0
2929701,Sátiro Dias,18,Litoral Norte e Agreste Baiano,20429,4,0,7,0,11,4,7,11,0,53.8450242303,19.580008811,34.2650154193,53.8450242303,0
2929750,Saubara,21,Recôncavo,12380,23,0,9,0,32,23,9,32,0,258.4814216478,185.7835218094,72.6978998384,258.4814216478,0
2929800,Saúde,16,Piemonte da Diamantina,13385,9,0,7,0,16,9,7,16,0,119.5367949197,67.2394471423,52.2973477774,119.5367949197,0
2929909,Seabra,3,Chapada Diamantina,45568,11,5,24,1,41,16,25,35,6,89.9754213483,35.1123595506,54.8630617978,76.8082865169,13.1671348315
2930006,Sebastião Laranjeiras,13,Sertão Produtivo,11696,5,0,9,0,14,5,9,14,0,119.6990424077,42.7496580027,76.9493844049,119.6990424077,0
2930105,Senhor do Bonfim,25,Piemonte Norte do Itapicuru,81218,5,15,18,1,39,20,19,23,16,48.0189120638,24.6250831097,23.3938289542,28.3188455761,19.7000664877
2930154,Serra do Ramalho,2,Velho Chico,32991,36,0,13,0,49,36,13,49,0,148.5253554,109.1206692734,39.4046861265,148.5253554,0
2930204,Sento Sé,10,Sertão do São Francisco,41891,8,0,11,0,19,8,11,19,0,45.3558043494,19.0971807787,26.2586235707,45.3558043494,0
2930303,Serra Dourada,23,Bacia do Rio Corrente,18320,62,0,13,0,75,62,13,75,0,409.3886462882,338.4279475983,70.96069869,409.3886462882,0
2930402,Serra Preta,15,Bacia do Jacuípe,16036,6,0,10,0,16,6,10,16,0,99.7755051135,37.4158144176,62.3596906959,99.7755051135,0
2930501,Serrinha,4,Sisal,83088,5,9,63,1,78,14,64,68,10,93.8763720393,16.8496052378,77.0267668015,81.8409397266,12.0354323127
2930600,Serrolândia,16,Piemonte da Diamantina,13832,10,0,7,0,17,10,7,17,0,122.9034123771,72.2961249277,50.6072874494,122.9034123771,0
2930709,Simões Filho,26,Metropolitano de Salvador,136050,1,6,51,1,59,7,52,52,7,43.3664094083,5.1451672179,38.2212421904,38.2212421904,5.1451672179
2930758,Sítio do Mato,2,Velho Chico,13437,1,0,15,0,16,1,15,16,0,119.0741981097,7.4421373819,111.6320607278,119.0741981097,0
2930766,Sítio do Quinto,17,Semiárido Nordeste II,11283,8,0,6,0,14,8,6,14,0,124.080475051,70.9031286005,53.1773464504,124.080475051,0
2930774,Sobradinho,10,Sertão do São Francisco,23713,2,0,13,0,15,2,13,15,0,63.2564416143,8.4341922152,54.8222493991,63.2564416143,0
2930808,Souto Soares,3,Chapada Diamantina,17503,3,0,10,0,13,3,10,13,0,74.2729817746,17.1399188711,57.1330629035,74.2729817746,0
2930907,Tabocas do Brejo Velho,23,Bacia do Rio Corrente,13057,9,0,11,0,20,9,11,20,0,153.1745423911,68.928544076,84.2459983151,153.1745423911,0
2931004,Tanhaçu,13,Sertão Produtivo,21315,4,0,11,0,15,4,11,15,0,70.3729767769,18.7661271405,51.6068496364,70.3729767769,0
2931053,Tanque Novo,13,Sertão Produtivo,17884,143,0,12,0,155,143,12,155,0,866.6964884813,799.5974055021,67.0990829792,866.6964884813,0
2931103,Tanquinho,19,Portal do Sertão,8232,4,0,3,0,7,4,3,7,0,85.0340136054,48.5908649174,36.443148688,85.0340136054,0
2931202,Taperoá,6,Baixo Sul,21462,9,0,11,0,20,9,11,20,0,93.1879601156,41.934582052,51.2533780636,93.1879601156,0
2931301,Tapiramutá,14,Piemonte do Paraguaçu,17845,7,0,4,1,12,7,5,11,1,67.2457270944,39.2266741384,28.019052956,61.6419165032,5.6038105912
2931350,Teixeira de Freitas,7,Extremo Sul,161690,6,50,123,26,205,56,149,129,76,126.7858247263,34.6341765106,92.1516482157,79.7822994619,47.0035252644
2931400,Teodoro Sampaio,19,Portal do Sertão,7936,9,0,5,0,14,9,5,14,0,176.4112903226,113.4072580645,63.0040322581,176.4112903226,0
2931509,Teofilândia,4,Sisal,23378,20,1,12,0,33,21,12,32,1,141.158354008,89.8280434597,51.3303105484,136.880828129,4.277525879
2931608,Teolândia,6,Baixo Sul,15357,10,0,10,0,20,10,10,20,0,130.2337696165,65.1168848082,65.1168848082,130.2337696165,0
2931707,Terra Nova,19,Portal do Sertão,13536,11,0,7,0,18,11,7,18,0,132.9787234043,81.2647754137,51.7139479905,132.9787234043,0
2931806,Tremedal,20,Sudoeste Baiano,17700,4,0,18,0,22,4,18,22,0,124.2937853107,22.5988700565,101.6949152542,124.2937853107,0
2931905,Tucano,4,Sisal,52540,4,0,31,0,35,4,31,35,0,66.6159116863,7.6132470499,59.0026646365,66.6159116863,0
2932002,Uauá,10,Sertão do São Francisco,25773,3,0,10,0,13,3,10,13,0,50.4403833469,11.6400884647,38.8002948822,50.4403833469,0
2932101,Ubaíra,9,Vale do Jiquiriçá,20800,3,0,13,0,16,3,13,16,0,76.9230769231,14.4230769231,62.5,76.9230769231,0
2932200,Ubaitaba,5,Litoral Sul,20489,8,0,10,0,18,8,10,18,0,87.8520181561,39.0453414027,48.8066767534,87.8520181561,0
2932309,Ubatã,22,Médio Rio de Contas,27527,7,0,16,0,23,7,16,23,0,83.5543284775,25.4295782323,58.1247502452,83.5543284775,0
2932408,Uibaí,1,Irecê,14474,8,0,7,0,15,8,7,15,0,103.6341025287,55.2715213486,48.36258118,103.6341025287,0
2932457,Umburanas,16,Piemonte da Diamantina,19522,2,0,6,0,8,2,6,8,0,40.9794078476,10.2448519619,30.7345558857,40.9794078476,0
2932507,Una,5,Litoral Sul,21331,42,1,28,0,71,43,28,70,1,332.848905349,201.58454831,131.2643570391,328.1608925976,4.6880127514
2932606,Urandi,13,Sertão Produtivo,17356,9,0,7,0,16,9,7,16,0,92.187139894,51.8552661904,40.3318737036,92.187139894,0
2932705,Uruçuca,5,Litoral Sul,21711,4,0,10,0,14,4,10,14,0,64.4834415734,18.4238404495,46.0596011239,64.4834415734,0
2932804,Utinga,3,Chapada Diamantina,19780,2,0,12,0,14,2,12,14,0,70.7785642063,10.111223458,60.6673407482,70.7785642063,0
2932903,Valença,6,Baixo Sul,98749,5,8,46,5,64,13,51,51,13,64.810782894,13.1646902753,51.6460926187,51.6460926187,13.1646902753
2933000,Valente,4,Sisal,28743,4,0,14,0,18,4,14,18,0,62.623943221,13.9164318269,48.7075113941,62.623943221,0
2933059,Várzea da Roça,15,Bacia do Jacuípe,14662,10,0,6,0,16,10,6,16,0,109.1256308826,68.2035193016,40.922111581,109.1256308826,0
2933109,Várzea do Poço,15,Bacia do Jacuípe,9449,4,0,4,0,8,4,4,8,0,84.66504392,42.33252196,42.33252196,84.66504392,0
2933158,Várzea Nova,16,Piemonte da Diamantina,13454,421,0,10,0,431,421,10,431,0,3203.5082503345,3129.1809127397,74.3273375948,3203.5082503345,0
2933174,Varzedo,21,Recôncavo,9375,4,0,6,0,10,4,6,10,0,106.6666666667,42.6666666667,64,106.6666666667,0
2933208,Vera Cruz,26,Metropolitano de Salvador,43640,9,0,31,0,40,9,31,40,0,91.6590284143,20.6232813932,71.0357470211,91.6590284143,0
2933257,Vereda,7,Extremo Sul,6620,10,0,8,0,18,10,8,18,0,271.9033232628,151.0574018127,120.8459214502,271.9033232628,0
2933307,Vitória da Conquista,20,Sudoeste Baiano,348718,11,163,279,37,490,174,316,290,200,140.5146852184,49.8970514857,90.6176337327,83.1617524762,57.3529327422
2933406,Wagner,3,Chapada Diamantina,9753,0,0,5,0,5,0,5,5,0,51.266277043,0,51.266277043,51.266277043,0
2933455,Wanderley,11,Bacia do Rio Grande,12935,0,0,13,0,13,0,13,13,0,100.5025125628,0,100.5025125628,100.5025125628,0
2933505,Wenceslau Guimarães,6,Baixo Sul,22365,0,0,20,0,20,0,20,20,0,89.4254415381,0,89.4254415381,89.4254415381,0
2933604,Xique-Xique,1,Irecê,48365,0,0,20,0,20,0,20,20,0,41.3522175127,0,41.3522175127,41.3522175127,0
