Código,Município,Código TI,Território de Identidade,População,QtMédicosSUS,QtMédicosNãoSUS,QtEnfermeirosSUS,QtEnfermeirosNãoSUS,QtProfissionais,Médicos,Enfermeiros,SUS,Não SUS,QtProfissionais/100000Hab,QtMédicos/100000Hab,QtEnfermeiros/100000Hab,QtSUS/100000Hab,QtNãoSUS/100000Hab
2900108,Abaíra,3,Chapada Diamantina,9199,8,0,6,0,14,8,6,14,0,152.1904554843,86.9659745625,65.2244809218,152.1904554843,0
2900207,Abaré,24,Itaparica,20189,12,0,16,0,28,12,16,28,0,138.6893853088,59.4383079895,79.2510773193,138.6893853088,0
2900306,Acajutiba,18,Litoral Norte e Agreste Baiano,15727,8,1,10,0,19,9,10,18,1,120.8113435493,57.2264258918,63.5849176575,114.4528517836,6.3584917658
2900355,Adustina,17,Semiárido Nordeste II,17349,8,0,9,0,17,8,9,17,0,97.9883566776,46.1121678483,51.8761888293,97.9883566776,0
2900405,Água Fria,19,Portal do Sertão,17508,6,0,15,0,21,6,15,21,0,119.9451679232,34.2700479781,85.6751199452,119.9451679232,0
2900504,Érico Cardoso,12,Bacia do Paramirim,11212,7,0,12,0,19,7,12,19,0,169.4612914734,62.4331073849,107.0281840885,169.4612914734,0
2900603,Aiquara,22,Médio Rio de Contas,4725,1,0,7,0,8,1,7,8,0,169.3121693122,21.164021164,148.1481481481,169.3121693122,0
2900702,Alagoinhas,18,Litoral Norte e Agreste Baiano,155979,147,133,134,27,441,280,161,281,160,282.7303675495,179.5113444759,103.2190230736,180.1524564204,102.5779111291
2900801,Alcobaça,7,Extremo Sul,23376,24,0,19,0,43,24,19,43,0,183.9493497604,102.6694045175,81.279945243,183.9493497604,0
2900900,Almadina,5,Litoral Sul,5985,8,0,7,0,15,8,7,15,0,250.626566416,133.6675020886,116.9590643275,250.626566416,0
2901007,Amargosa,9,Vale do Jiquiriçá,38259,25,10,33,0,68,35,33,58,10,177.7359575525,91.4817428579,86.2542146946,151.5983167359,26.1376408165
2901106,Amélia Rodrigues,19,Portal do Sertão,26409,14,1,14,0,29,15,14,28,1,109.8110492635,56.7988185846,53.0122306789,106.0244613579,3.7865879056
2901155,América Dourada,1,Irecê,16798,12,0,15,0,27,12,15,27,0,160.7334206453,71.4370758424,89.296344803,160.7334206453,0
2901205,Anagé,20,Sudoeste Baiano,19568,22,0,22,0,44,22,22,44,0,224.8569092396,112.4284546198,112.4284546198,224.8569092396,0
2901304,Andaraí,3,Chapada Diamantina,13737,11,0,7,0,18,11,7,18,0,131.0329766325,80.0757079421,50.9572686904,131.0329766325,0
2901353,Andorinha,25,Piemonte Norte do Itapicuru,15490,5,1,10,0,16,6,10,15,1,103.2924467398,38.7346675274,64.5577792124,96.8366688186,6.4557779212
2901403,Angical,11,Bacia do Rio Grande,14690,10,0,8,0,18,10,8,18,0,122.5323349217,68.073519401,54.4588155208,122.5323349217,0
2901502,Anguera,19,Portal do Sertão,11481,8,0,11,0,19,8,11,19,0,165.490810905,69.6803414337,95.8104694713,165.490810905,0
2901601,Antas,17,Semiárido Nordeste II,19569,18,0,17,0,35,18,17,35,0,178.8543103889,91.9822167714,86.8720936175,178.8543103889,0
2901700,Antônio Cardoso,19,Portal do Sertão,12208,4,0,12,0,16,4,12,16,0,131.0615989515,32.7653997379,98.2961992136,131.0615989515,0
2901809,Antônio Gonçalves,25,Piemonte Norte do Itapicuru,12072,8,0,10,0,18,8,10,18,0,149.1053677932,66.2690523526,82.8363154407,149.1053677932,0
2901908,Aporá,18,Litoral Norte e Agreste Baiano,18334,13,0,8,0,21,13,8,21,0,114.5412894077,70.9065124905,43.6347769172,114.5412894077,0
2901957,Apuarema,22,Médio Rio de Contas,7730,6,0,7,0,13,6,7,13,0,168.1759379043,77.6196636481,90.5562742561,168.1759379043,0
2902005,Aracatu,20,Sudoeste Baiano,13962,8,0,13,0,21,8,13,21,0,150.4082509669,57.2983813207,93.1098696462,150.4082509669,0
2902054,Araçás,18,Litoral Norte e Agreste Baiano,12608,8,0,14,0,22,8,14,22,0,174.4923857868,63.4517766497,111.0406091371,174.4923857868,0
2902104,Araci,4,Sisal,55935,21,2,35,0,58,23,35,56,2,103.6917851077,41.1191561634,62.5726289443,100.1162063109,3.5755787968
2902203,Aramari,18,Litoral Norte e Agreste Baiano,11703,1,0,6,0,7,1,6,7,0,59.813722977,8.5448175681,51.2689054089,59.813722977,0
2902252,Arataca,5,Litoral Sul,11661,3,0,10,0,13,3,10,13,0,111.4827201784,25.7267815796,85.7559385987,111.4827201784,0
2902302,Aratuípe,6,Baixo Sul,9171,3,0,9,0,12,3,9,12,0,130.8472358521,32.711808963,98.1354268891,130.8472358521,0
2902401,Aurelino Leal,5,Litoral Sul,12706,7,0,9,0,16,7,9,16,0,125.9247599559,55.0920824807,70.8326774752,125.9247599559,0
2902500,Baianópolis,11,Bacia do Rio Grande,14323,8,0,12,0,20,8,12,20,0,139.6355512113,55.8542204845,83.7813307268,139.6355512113,0
2902609,Baixa Grande,15,Bacia do Jacuípe,21403,13,0,11,0,24,13,11,24,0,112.1338130169,60.7391487175,51.3946642994,112.1338130169,0
2902658,Banzaê,17,Semiárido Nordeste II,13765,8,0,17,0,25,8,17,25,0,181.6200508536,58.1184162732,123.5016345805,181.6200508536,0
2902708,Barra,2,Velho Chico,54915,34,0,36,0,70,34,36,70,0,127.4697259401,61.9138668852,65.5558590549,127.4697259401,0
2902807,Barra da Estiva,3,Chapada Diamantina,22082,16,2,22,0,40,18,22,38,2,181.1430124083,81.5143555837,99.6286568246,172.0858617879,9.0571506204
2902906,Barra do Choça,20,Sudoeste Baiano,34121,25,1,22,0,48,26,22,47,1,140.6758301339,76.1994079892,64.4764221447,137.7450836728,2.9307464611
2903003,Barra do Mendes,1,Irecê,14560,5,0,20,0,25,5,20,25,0,171.7032967033,34.3406593407,137.3626373626,171.7032967033,0
2903102,Barra do Rocha,22,Médio Rio de Contas,6258,2,0,4,0,6,2,4,6,0,95.8772770853,31.9590923618,63.9181847236,95.8772770853,0
2903201,Barreiras,11,Bacia do Rio Grande,157638,178,86,257,6,527,264,263,435,92,334.3102551415,167.472309976,166.8379451655,275.9486925741,58.3615625674
2903235,Barro Alto,1,Irecê,15217,5,0,8,0,13,5,8,13,0,85.4307682198,32.8579877768,52.5727804429,85.4307682198,0
2903276,Barrocas,4,Sisal,16296,5,1,15,0,21,6,15,20,1,128.8659793814,36.8188512518,92.0471281296,122.7295041728,6.1364752086
2903300,Barro Preto,5,Litoral Sul,6251,7,0,7,0,14,7,7,14,0,223.9641657335,111.9820828667,111.9820828667,223.9641657335,0
2903409,Belmonte,27,Costa do Descobrimento,24013,19,0,19,0,38,19,19,38,0,158.2476158747,79.1238079374,79.1238079374,158.2476158747,0
2903508,Belo Campo,20,Sudoeste Baiano,18247,11,0,21,0,32,11,21,32,0,175.3712939113,60.283882282,115.0874116293,175.3712939113,0
2903607,Biritinga,4,Sisal,16653,9,0,16,0,25,9,16,25,0,150.1231009428,54.0443163394,96.0787846034,150.1231009428,0
2903706,Boa Nova,22,Médio Rio de Contas,14069,5,0,9,0,14,5,9,14,0,99.5095600256,35.5391285806,63.970431445,99.5095600256,0
2903805,Boa Vista do Tupim,14,Piemonte do Paraguaçu,19502,16,0,12,0,28,16,12,28,0,143.5750179469,82.0428673982,61.5321505487,143.5750179469,0
2903904,Bom Jesus da Lapa,2,Velho Chico,70618,55,9,80,0,144,64,80,135,9,203.9140162565,90.6284516695,113.2855645869,191.1693902404,12.744626016
2903953,Bom Jesus da Serra,20,Sudoeste Baiano,10477,9,0,9,0,18,9,9,18,0,171.8049059845,85.9024529923,85.9024529923,171.8049059845,0
2904001,Boninal,3,Chapada Diamantina,14760,4,0,7,0,11,4,7,11,0,74.5257452575,27.1002710027,47.4254742547,74.5257452575,0
2904050,Bonito,3,Chapada Diamantina,17131,5,0,10,0,15,5,10,15,0,87.5605627225,29.1868542409,58.3737084817,87.5605627225,0
2904100,Boquira,12,Bacia do Paramirim,22464,9,0,13,0,22,9,13,22,0,97.9344729345,40.0641025641,57.8703703704,97.9344729345,0
2904209,Botuporã,12,Bacia do Paramirim,10898,7,0,9,0,16,7,9,16,0,146.8159295284,64.2319691687,82.5839603597,146.8159295284,0
2904308,Brejões,9,Vale do Jiquiriçá,15122,5,0,6,0,11,5,6,11,0,72.7417008332,33.0644094696,39.6772913636,72.7417008332,0
2904407,Brejolândia,23,Bacia do Rio Corrente,10833,6,0,5,0,11,6,5,11,0,101.541585895,55.3863195791,46.1552663159,101.541585895,0
2904506,Brotas de Macaúbas,2,Velho Chico,10974,6,0,10,0,16,6,10,16,0,145.7991616548,54.6746856206,91.1244760343,145.7991616548,0
2904605,Brumado,13,Sertão Produtivo,69677,72,28,61,4,165,100,65,133,32,236.8069807828,143.5193822926,93.2875984902,190.8807784491,45.9262023336
2904704,Buerarema,5,Litoral Sul,19256,7,0,14,0,21,7,14,21,0,109.0569173245,36.3523057748,72.7046115496,109.0569173245,0
2904753,Buritirama,11,Bacia do Rio Grande,21786,7,0,15,0,22,7,15,22,0,100.9822821996,32.1307261544,68.8515560452,100.9822821996,0
2904803,Caatiba,8,Médio Sudoeste da Bahia,7841,4,0,7,0,11,4,7,11,0,140.2882285423,51.0139012881,89.2743272542,140.2882285423,0
2904852,Cabaceiras do Paraguaçu,21,Recôncavo,19312,9,0,18,0,27,9,18,27,0,139.8094449047,46.6031483016,93.2062966031,139.8094449047,0
2904902,Cachoeira,21,Recôncavo,35139,24,8,26,0,58,32,26,50,8,165.0587666126,91.0669057173,73.9918608953,142.2920401833,22.7667264293
2905008,Caculé,13,Sertão Produtivo,23817,11,11,18,1,41,22,19,29,12,172.1459461729,92.3709955074,79.7749506655,121.7617668052,50.3841793677
2905107,Caém,16,Piemonte da Diamantina,10058,6,0,5,0,11,6,5,11,0,109.3656790614,59.6540067608,49.7116723007,109.3656790614,0
2905156,Caetanos,20,Sudoeste Baiano,16106,4,0,7,0,11,4,7,11,0,68.2975288712,24.8354650441,43.4620638271,68.2975288712,0
2905206,Caetité,13,Sertão Produtivo,52853,58,8,38,1,105,66,39,96,9,198.664219628,124.8746523376,73.7895672904,181.6358579456,17.0283616824
2905305,Cafarnaum,1,Irecê,19006,10,0,15,0,25,10,15,25,0,131.5374092392,52.6149636957,78.9224455435,131.5374092392,0
2905404,Cairu,6,Baixo Sul,18224,12,0,10,0,22,12,10,22,0,120.719929763,65.8472344162,54.8726953468,120.719929763,0
2905503,Caldeirão Grande,25,Piemonte Norte do Itapicuru,13713,9,0,10,0,19,9,10,19,0,138.5546561657,65.6311529206,72.9235032451,138.5546561657,0
2905602,Camacan,5,Litoral Sul,33310,29,2,30,0,61,31,30,59,2,183.1281897328,93.0651456019,90.0630441309,177.1239867908,6.0042029421
2905701,Camaçari,26,Metropolitano de Salvador,296893,360,121,251,16,748,481,267,611,137,251.942619058,162.0112296349,89.9313894231,205.7980484552,46.1445706029
2905800,Camamu,6,Baixo Sul,36644,14,6,20,0,40,20,20,34,6,109.1583888222,54.5791944111,54.5791944111,92.7846304989,16.3737583233
2905909,Campo Alegre de Lourdes,10,Sertão do São Francisco,30048,12,0,19,0,31,12,19,31,0,103.1682641108,39.9361022364,63.2321618743,103.1682641108,0
2906006,Campo Formoso,25,Piemonte Norte do Itapicuru,73448,42,9,34,0,85,51,34,76,9,115.7281341902,69.4368805141,46.2912536761,103.4745670406,12.2535671495
2906105,Canápolis,23,Bacia do Rio Corrente,10151,7,0,5,0,12,7,5,12,0,118.2149541917,68.9587232785,49.2562309132,118.2149541917,0
2906204,Canarana,1,Irecê,26862,12,0,16,0,28,12,16,28,0,104.2364678728,44.6727719455,59.5636959273,104.2364678728,0
2906303,Canavieiras,5,Litoral Sul,33002,18,4,17,1,40,22,18,35,5,121.2047754682,66.6626265075,54.5421489607,106.0541785346,15.1505969335
2906402,Candeal,4,Sisal,8837,9,0,8,0,17,9,8,17,0,192.3729772547,101.8445173701,90.5284598846,192.3729772547,0
2906501,Candeias,26,Metropolitano de Salvador,89707,69,41,75,17,202,110,92,144,58,225.1775223784,122.6214230774,102.5560993011,160.5225902104,64.6549321681
2906600,Candiba,13,Sertão Produtivo,14792,2,0,5,0,7,2,5,7,0,47.3228772309,13.520822066,33.802055165,47.3228772309,0
2906709,Cândido Sales,20,Sudoeste Baiano,26674,11,0,22,0,33,11,22,33,0,123.715978106,41.2386593687,82.4773187373,123.715978106,0
2906808,Cansanção,4,Sisal,36191,20,1,18,0,39,21,18,38,1,107.7615981874,58.0254759471,49.7361222403,104.9984802852,2.7631179022
2906824,Canudos,10,Sertão do São Francisco,17316,8,0,9,0,17,8,9,17,0,98.1750981751,46.2000462,51.9750519751,98.1750981751,0
2906857,Capela do Alto Alegre,15,Bacia do Jacuípe,12199,4,0,13,0,17,4,13,17,0,139.3556848922,32.7895729158,106.5661119764,139.3556848922,0
2906873,Capim Grosso,15,Bacia do Jacuípe,31392,18,2,29,0,49,20,29,47,2,156.0907237513,63.7104994903,92.380224261,149.7196738022,6.371049949
2906899,Caraíbas,20,Sudoeste Baiano,9773,6,0,12,0,18,6,12,18,0,184.1809065794,61.3936355265,122.7872710529,184.1809065794,0
2906907,Caravelas,7,Extremo Sul,22740,6,0,18,0,24,6,18,24,0,105.5408970976,26.3852242744,79.1556728232,105.5408970976,0
2907004,Cardeal da Silva,18,Litoral Norte e Agreste Baiano,9544,7,0,4,0,11,7,4,11,0,115.255658005,73.3445096396,41.9111483655,115.255658005,0
2907103,Carinhanha,2,Velho Chico,30118,14,3,16,0,33,17,16,30,3,109.5690284879,56.4446510392,53.1243774487,99.6082077163,9.9608207716
2907202,Casa Nova,10,Sertão do São Francisco,73382,36,1,26,0,63,37,26,62,1,85.8521163228,50.4210841896,35.4310321332,84.4893843177,1.3627320051
2907301,Castro Alves,21,Recôncavo,27238,23,2,26,1,52,25,27,49,3,190.9097584257,91.7835377047,99.1262207211,179.8957339012,11.0140245246
2907400,Catolândia,11,Bacia do Rio Grande,3669,2,0,3,0,5,2,3,5,0,136.2769146907,54.5107658763,81.7661488144,136.2769146907,0
2907509,Catu,18,Litoral Norte e Agreste Baiano,56459,22,29,36,13,100,51,49,58,42,177.1196797676,90.3310366815,86.7886430861,102.7294142652,74.3902655024
2907558,Caturama,12,Bacia do Paramirim,9764,7,0,12,0,19,7,12,19,0,194.5923801721,71.6919295371,122.900450635,194.5923801721,0
2907608,Central,1,Irecê,17969,10,0,17,0,27,10,17,27,0,150.2587790083,55.6513996327,94.6073793756,150.2587790083,0
2907707,Chorrochó,24,Itaparica,11591,4,0,10,0,14,4,10,14,0,120.783366405,34.5095332586,86.2738331464,120.783366405,0
2907806,Cícero Dantas,17,Semiárido Nordeste II,34676,23,5,22,0,50,28,22,45,5,144.1919483216,80.7474910601,63.4444572615,129.7727534894,14.4191948322
2907905,Cipó,17,Semiárido Nordeste II,17739,8,0,15,0,23,8,15,23,0,129.6578161114,45.0983708214,84.55944529,129.6578161114,0
2908002,Coaraci,5,Litoral Sul,19022,14,2,22,0,38,16,22,36,2,199.7686888866,84.1131321628,115.6555567238,189.2545473662,10.5141415203
2908101,Cocos,23,Bacia do Rio Corrente,19498,14,0,14,0,28,14,14,28,0,143.6044722536,71.8022361268,71.8022361268,143.6044722536,0
2908200,Conceição da Feira,19,Portal do Sertão,23024,18,1,19,1,39,19,20,37,2,169.3884642113,82.5225851286,86.8658790827,160.701876303,8.6865879083
2908309,Conceição do Almeida,21,Recôncavo,18229,11,0,15,0,26,11,15,26,0,142.6298754731,60.343408854,82.2864666191,142.6298754731,0
2908408,Conceição do Coité,4,Sisal,68303,32,22,44,3,101,54,47,76,25,147.8705181324,79.0594849421,68.8110331903,111.2689047333,36.6016133991
2908507,Conceição do Jacuípe,19,Portal do Sertão,33876,43,9,31,1,84,52,32,74,10,247.9631597591,153.5010036604,94.4621560987,218.4437359783,29.5194237808
2908606,Conde,18,Litoral Norte e Agreste Baiano,26371,15,0,18,0,33,15,18,33,0,125.1374616056,56.8806643662,68.2567972394,125.1374616056,0
2908705,Condeúba,20,Sudoeste Baiano,18191,18,2,26,0,46,20,26,44,2,252.8722994888,109.9444780386,142.9278214502,241.8778516849,10.9944478039
2908804,Contendas do Sincorá,13,Sertão Produtivo,4299,3,0,4,0,7,3,4,7,0,162.8285647825,69.7836706211,93.0448941614,162.8285647825,0
2908903,Coração de Maria,19,Portal do Sertão,23896,16,0,17,0,33,16,17,33,0,138.0984265149,66.9568128557,71.1416136592,138.0984265149,0
2909000,Cordeiros,20,Sudoeste Baiano,8904,8,0,10,0,18,8,10,18,0,202.1563342318,89.8472596586,112.3090745732,202.1563342318,0
2909109,Coribe,23,Bacia do Rio Corrente,14933,8,0,17,0,25,8,17,25,0,167.4144512154,53.5726243889,113.8418268265,167.4144512154,0
2909208,Coronel João Sá,17,Semiárido Nordeste II,16814,7,0,11,0,18,7,11,18,0,107.0536457714,41.6319733555,65.4216724158,107.0536457714,0
2909307,Correntina,23,Bacia do Rio Corrente,33361,14,0,18,1,33,14,19,32,1,98.9178981445,41.9651689098,56.9527292347,95.9203860796,2.997512065
2909406,Cotegipe,11,Bacia do Rio Grande,14414,3,0,9,0,12,3,9,12,0,83.2523935063,20.8130983766,62.4392951297,83.2523935063,0
2909505,Cravolândia,9,Vale do Jiquiriçá,5576,3,0,6,0,9,3,6,9,0,161.406025825,53.8020086083,107.6040172166,161.406025825,0
2909604,Crisópolis,18,Litoral Norte e Agreste Baiano,21835,16,0,19,0,35,16,19,35,0,160.2931073964,73.2768490955,87.0162583009,160.2931073964,0
2909703,Cristópolis,11,Bacia do Rio Grande,14403,6,0,14,0,20,6,14,20,0,138.8599597306,41.6579879192,97.2019718114,138.8599597306,0
2909802,Cruz das Almas,21,Recôncavo,64932,53,35,52,4,144,88,56,105,39,221.7704675661,135.5263968459,86.2440707201,161.7076326003,60.0628349658
2909901,Curaçá,10,Sertão do São Francisco,35524,21,0,19,0,40,21,19,40,0,112.59993244,59.114964531,53.484967909,112.59993244,0
2910008,Dário Meira,22,Médio Rio de Contas,11716,3,0,9,0,12,3,9,12,0,102.424035507,25.6060088767,76.8180266302,102.424035507,0
2910057,Dias D'Ávila,26,Metropolitano de Salvador,80657,37,17,41,3,98,54,44,78,20,121.5021634824,66.9501717148,54.5519917676,96.705803588,24.7963598944
2910107,Dom Basílio,13,Sertão Produtivo,12604,11,0,12,0,23,11,12,23,0,182.4817518248,87.2738813075,95.2078705173,182.4817518248,0
2910206,Dom Macedo Costa,21,Recôncavo,4212,4,0,5,0,9,4,5,9,0,213.6752136752,94.9667616334,118.7084520418,213.6752136752,0
2910305,Elísio Medrado,9,Vale do Jiquiriçá,8461,4,0,8,0,12,4,8,12,0,141.8272071859,47.2757357286,94.5514714573,141.8272071859,0
2910404,Encruzilhada,20,Sudoeste Baiano,19376,12,0,14,0,26,12,14,26,0,134.1866226259,61.9322873658,72.2543352601,134.1866226259,0
2910503,Entre Rios,18,Litoral Norte e Agreste Baiano,43223,19,4,35,0,58,23,35,54,4,134.1878166717,53.2124100595,80.9754066122,124.9334844874,9.2543321843
2910602,Esplanada,18,Litoral Norte e Agreste Baiano,37845,16,2,26,0,44,18,26,42,2,116.2637072268,47.5624256837,68.7012815431,110.978993262,5.2847139649
2910701,Euclides da Cunha,17,Semiárido Nordeste II,61924,50,5,43,1,99,55,44,93,6,159.8733931917,88.8185517731,71.0548414185,150.1840966346,9.6892965571
2910727,Eunápolis,27,Costa do Descobrimento,115290,116,47,129,7,299,163,136,245,54,259.3459970509,141.382600399,117.9633966519,212.5075895568,46.8384074941
2910750,Fátima,17,Semiárido Nordeste II,18443,2,1,12,1,16,3,13,14,2,86.7537819227,16.2663341105,70.4874478122,75.9095591823,10.8442227403
2910776,Feira da Mata,2,Velho Chico,5922,4,0,5,0,9,4,5,9,0,151.9756838906,67.5447483958,84.4309354948,151.9756838906,0
2910800,Feira de Santana,19,Portal do Sertão,627477,822,132,753,33,1740,954,786,1575,165,277.3010006741,152.0374451972,125.2635554769,251.0052161274,26.2957845467
2910859,Filadélfia,25,Piemonte Norte do Itapicuru,17176,18,0,15,0,33,18,15,33,0,192.1285514672,104.7973917094,87.3311597578,192.1285514672,0
2910909,Firmino Alves,8,Médio Sudoeste da Bahia,5822,2,0,3,0,5,2,3,5,0,85.8811405015,34.3524562006,51.5286843009,85.8811405015,0
2911006,Floresta Azul,5,Litoral Sul,11244,3,0,9,0,12,3,9,12,0,106.7235859125,26.6808964781,80.0426894344,106.7235859125,0
2911105,Formosa do Rio Preto,11,Bacia do Rio Grande,25912,9,0,20,0,29,9,20,29,0,111.9172584131,34.7329422661,77.184316147,111.9172584131,0
2911204,Gandu,6,Baixo Sul,33234,17,15,25,3,60,32,28,42,18,180.5380032497,96.2869350665,84.2510681832,126.3766022748,54.1614009749
2911253,Gavião,15,Bacia do Jacuípe,4725,3,0,5,0,8,3,5,8,0,169.3121693122,63.4920634921,105.8201058201,169.3121693122,0
2911303,Gentio do Ouro,1,Irecê,11639,5,0,6,0,11,5,6,11,0,94.5098376149,42.9590170977,51.5508205172,94.5098376149,0
2911402,Glória,24,Itaparica,15840,7,0,6,0,13,7,6,13,0,82.0707070707,44.1919191919,37.8787878788,82.0707070707,0
2911501,Gongogi,22,Médio Rio de Contas,7848,9,0,8,0,17,9,8,17,0,216.6156982671,114.6788990826,101.9367991845,216.6156982671,0
2911600,Governador Mangabeira,21,Recôncavo,21495,13,1,13,2,29,14,15,26,3,134.9150965341,65.131425913,69.7836706211,120.9583624099,13.9567341242
2911659,Guajeru,20,Sudoeste Baiano,8081,6,0,8,0,14,6,8,14,0,173.2458854102,74.2482366044,98.9976488058,173.2458854102,0
2911709,Guanambi,13,Sertão Produtivo,86808,134,28,165,4,331,162,169,299,32,381.3012625564,186.6187448161,194.6825177403,344.4383006175,36.862961939
2911808,Guaratinga,27,Costa do Descobrimento,22154,11,0,15,0,26,11,15,26,0,117.3602961091,49.6524329692,67.7078631398,117.3602961091,0
2911857,Heliópolis,17,Semiárido Nordeste II,13718,4,0,7,0,11,4,7,11,0,80.1866161248,29.1587694999,51.0278466249,80.1866161248,0
2911907,Iaçu,14,Piemonte do Paraguaçu,25884,12,2,17,0,31,14,17,29,2,119.7651058569,54.0874671612,65.6776386957,112.0383248339,7.726781023
2912004,Ibiassucê,13,Sertão Produtivo,10183,6,0,7,0,13,6,7,13,0,127.6637533143,58.9217322989,68.7420210154,127.6637533143,0
2912103,Ibicaraí,5,Litoral Sul,23529,10,0,27,0,37,10,27,37,0,157.2527519232,42.500743763,114.7520081601,157.2527519232,0
2912202,Ibicoara,3,Chapada Diamantina,19786,6,1,16,0,23,7,16,22,1,116.2438087537,35.3785504902,80.8652582634,111.1897301122,5.0540786415
2912301,Ibicuí,8,Médio Sudoeste da Bahia,16796,6,3,18,0,27,9,18,24,3,160.7525601334,53.5841867111,107.1683734222,142.891164563,17.8613955704
2912400,Ibipeba,1,Irecê,18678,4,0,8,0,12,4,8,12,0,64.2467073562,21.4155691187,42.8311382375,64.2467073562,0
2912509,Ibipitanga,12,Bacia do Paramirim,15413,3,1,6,0,10,4,6,9,1,64.8802958541,25.9521183417,38.9281775125,58.3922662687,6.4880295854
2912608,Ibiquera,14,Piemonte do Paraguaçu,4214,3,0,6,0,9,3,6,9,0,213.5738016137,71.1912672046,142.3825344091,213.5738016137,0
2912707,Ibirapitanga,6,Baixo Sul,24293,8,1,12,0,21,9,12,20,1,86.4446548388,37.0477092166,49.3969456222,82.3282427037,4.1164121352
2912806,Ibirapoã,7,Extremo Sul,8852,7,0,6,0,13,7,6,13,0,146.8594667872,79.0781744239,67.7812923633,146.8594667872,0
2912905,Ibirataia,22,Médio Rio de Contas,17221,11,0,16,0,27,11,16,27,0,156.7853202485,63.875500842,92.9098194065,156.7853202485,0
2913002,Ibitiara,3,Chapada Diamantina,16855,5,0,10,0,15,5,10,15,0,88.9943636903,29.6647878968,59.3295757935,88.9943636903,0
2913101,Ibititá,1,Irecê,17948,6,0,11,0,17,6,11,17,0,94.7180744373,33.4299086249,61.2881658123,94.7180744373,0
2913200,Ibotirama,2,Velho Chico,27862,14,8,36,3,61,22,39,50,11,218.9361854856,78.9605914866,139.975593999,179.4558897423,39.4802957433
2913309,Ichu,4,Sisal,6437,6,0,7,0,13,6,7,13,0,201.9574335871,93.211123194,108.746310393,201.9574335871,0
2913408,Igaporã,2,Velho Chico,16283,4,0,13,0,17,4,13,17,0,104.4033654732,24.5654977584,79.8378677148,104.4033654732,0
2913457,Igrapiúna,6,Baixo Sul,14187,7,0,14,0,21,7,14,21,0,148.0228378093,49.3409459364,98.6818918728,148.0228378093,0
2913507,Iguaí,8,Médio Sudoeste da Bahia,27939,11,0,11,0,22,11,11,22,0,78.7429757686,39.3714878843,39.3714878843,78.7429757686,0
2913606,Ilhéus,5,Litoral Sul,176341,219,54,230,13,516,273,243,449,67,292.6148768579,154.8136848492,137.8011920087,254.620309514,37.994567344
2913705,Inhambupe,18,Litoral Norte e Agreste Baiano,40453,20,0,19,0,39,20,19,39,0,96.408177391,49.4400909698,46.9680864213,96.408177391,0
2913804,Ipecaetá,19,Portal do Sertão,15499,6,0,8,0,14,6,8,14,0,90.3284082844,38.712174979,51.6162333054,90.3284082844,0
2913903,Ipiaú,22,Médio Rio de Contas,47704,43,10,53,3,109,53,56,96,13,228.4923696126,111.1017943988,117.3905752138,201.2409860808,27.2513835318
2914000,Ipirá,15,Bacia do Jacuípe,62631,26,6,33,2,67,32,35,59,8,106.9757787677,51.0929092622,55.8828695055,94.2025514522,12.7732273155
2914109,Ipupiara,1,Irecê,10157,3,0,9,0,12,3,9,12,0,118.145121591,29.5362803978,88.6088411933,118.145121591,0
2914208,Irajuba,9,Vale do Jiquiriçá,7521,2,0,7,0,9,2,7,9,0,119.6649381731,26.5922084829,93.0727296902,119.6649381731,0
2914307,Iramaia,3,Chapada Diamantina,9901,7,0,9,0,16,7,9,16,0,161.5998384002,70.6999293001,90.8999091001,161.5998384002,0
2914406,Iraquara,3,Chapada Diamantina,25536,11,0,7,0,18,11,7,18,0,70.4887218045,43.0764411028,27.4122807018,70.4887218045,0
2914505,Irará,19,Portal do Sertão,29879,9,2,21,0,32,11,21,30,2,107.0986311456,36.8151544563,70.2834766893,100.404966699,6.6936644466
2914604,Irecê,1,Irecê,74483,142,7,113,1,263,149,114,255,8,353.100707544,200.0456480002,153.0550595438,342.3600016111,10.7407059329
2914653,Itabela,27,Costa do Descobrimento,31422,11,1,28,0,40,12,28,39,1,127.2993444084,38.1898033225,89.1095410859,124.1168607982,3.1824836102
2914703,Itaberaba,14,Piemonte do Paraguaçu,66806,32,14,50,3,99,46,53,82,17,148.19028231,68.8560907703,79.3341915397,122.7434661557,25.4468161542
2914802,Itabuna,5,Litoral Sul,221046,344,42,328,26,740,386,354,672,68,334.7719479203,174.6242863476,160.1476615727,304.0091202736,30.7628276467
2914901,Itacaré,5,Litoral Sul,28382,11,4,17,0,32,15,17,28,4,112.7475160313,52.8503981397,59.8971178916,98.6540765274,14.0934395039
2915007,Itaetê,3,Chapada Diamantina,16586,6,0,10,0,16,6,10,16,0,96.466899795,36.1750874231,60.2918123719,96.466899795,0
2915106,Itagi,22,Médio Rio de Contas,13199,7,0,9,0,16,7,9,16,0,121.2213046443,53.0343207819,68.1869838624,121.2213046443,0
2915205,Itagibá,22,Médio Rio de Contas,15577,5,0,9,0,14,5,9,14,0,89.8760993773,32.0986069205,57.7774924568,89.8760993773,0
2915304,Itagimirim,27,Costa do Descobrimento,7291,1,0,4,0,5,1,4,5,0,68.5776985324,13.7155397065,54.8621588259,68.5776985324,0
2915353,Itaguaçu da Bahia,1,Irecê,14718,5,0,9,0,14,5,9,14,0,95.1216197853,33.9720070662,61.1496127191,95.1216197853,0
2915403,Itaju do Colônia,5,Litoral Sul,7218,4,0,6,0,10,4,6,10,0,138.5425325575,55.417013023,83.1255195345,138.5425325575,0
2915502,Itajuípe,5,Litoral Sul,21642,5,0,13,0,18,5,13,18,0,83.1716107569,23.1032252102,60.0683855466,83.1716107569,0
2915601,Itamaraju,7,Extremo Sul,67356,40,10,62,5,117,50,67,102,15,173.7039016569,74.2324366055,99.4714650514,151.4341706752,22.2697309816
2915700,Itamari,22,Médio Rio de Contas,8476,7,0,8,0,15,7,8,15,0,176.9702689948,82.5861255309,94.3841434639,176.9702689948,0
2915809,Itambé,8,Médio Sudoeste da Bahia,24901,12,0,20,0,32,12,20,32,0,128.5088952251,48.1908357094,80.3180595157,128.5088952251,0
2915908,Itanagra,18,Litoral Norte e Agreste Baiano,6730,4,0,6,0,10,4,6,10,0,148.588410104,59.4353640416,89.1530460624,148.588410104,0
2916005,Itanhém,7,Extremo Sul,20501,13,2,16,0,31,15,16,29,2,151.2121359934,73.1671625774,78.0449734159,141.4565143164,9.755621677
2916104,Itaparica,26,Metropolitano de Salvador,22866,15,3,20,0,38,18,20,35,3,166.1856030788,78.7194961952,87.4661068836,153.0656870463,13.1199160325
2916203,Itapé,5,Litoral Sul,9830,4,0,13,0,17,4,13,17,0,172.9399796541,40.6917599186,132.2482197355,172.9399796541,0
2916302,Itapebi,27,Costa do Descobrimento,10830,8,0,12,0,20,8,12,20,0,184.6722068329,73.8688827331,110.8033240997,184.6722068329,0
2916401,Itapetinga,8,Médio Sudoeste da Bahia,77533,48,27,61,0,136,75,61,109,27,175.409180607,96.7330040112,78.6761765958,140.5852991629,34.823881444
2916500,Itapicuru,18,Litoral Norte e Agreste Baiano,36211,16,0,19,0,35,16,19,35,0,96.6557123526,44.185468504,52.4702438486,96.6557123526,0
2916609,Itapitanga,5,Litoral Sul,10799,3,0,8,0,11,3,8,11,0,101.8612834522,27.7803500324,74.0809334198,101.8612834522,0
2916708,Itaquara,9,Vale do Jiquiriçá,8592,4,0,8,0,12,4,8,12,0,139.6648044693,46.5549348231,93.1098696462,139.6648044693,0
2916807,Itarantim,8,Médio Sudoeste da Bahia,20314,10,1,15,0,26,11,15,25,1,127.9905483903,54.1498473959,73.8407009944,123.0678349906,4.9227133996
2916856,Itatim,14,Piemonte do Paraguaçu,14957,8,0,16,0,24,8,16,24,0,160.4599852912,53.4866617637,106.9733235274,160.4599852912,0
2916906,Itiruçu,9,Vale do Jiquiriçá,13254,4,0,9,0,13,4,9,13,0,98.0835974046,30.1795684322,67.9040289724,98.0835974046,0
2917003,Itiúba,4,Sisal,37567,16,1,10,0,27,17,10,26,1,71.8715894269,45.2524822317,26.6191071951,69.2096787074,2.6619107195
2917102,Itororó,8,Médio Sudoeste da Bahia,21241,5,1,11,0,17,6,11,16,1,80.0338967092,28.2472576621,51.7866390471,75.3260204322,4.707876277
2917201,Ituaçu,13,Sertão Produtivo,19577,12,0,13,0,25,12,13,25,0,127.700873474,61.2964192675,66.4044542065,127.700873474,0
2917300,Ituberá,6,Baixo Sul,29428,9,2,14,2,27,11,16,23,4,91.7493543564,37.3793665896,54.3699877668,78.1568574147,13.5924969417
2917334,Iuiu,13,Sertão Produtivo,11399,7,0,8,0,15,7,8,15,0,131.5904903939,61.4088955172,70.1815948767,131.5904903939,0
2917359,Jaborandi,23,Bacia do Rio Corrente,9056,6,0,15,0,21,6,15,21,0,231.890459364,66.2544169611,165.6360424028,231.890459364,0
2917409,Jacaraci,20,Sudoeste Baiano,15459,6,0,15,0,21,6,15,21,0,135.843198137,38.8123423249,97.0308558121,135.843198137,0
2917508,Jacobina,16,Piemonte da Diamantina,83635,40,40,64,4,148,80,68,104,44,176.9594069469,95.6537334848,81.3056734621,124.3498535302,52.6095534166
2917607,Jaguaquara,9,Vale do Jiquiriçá,56033,18,8,41,1,68,26,42,59,9,121.3570574483,46.4012278479,74.9558296004,105.2950939625,16.0619634858
2917706,Jaguarari,25,Piemonte Norte do Itapicuru,34499,13,1,11,3,28,14,14,24,4,81.161772805,40.5808864025,40.5808864025,69.5672338329,11.5945389721
2917805,Jaguaripe,6,Baixo Sul,19036,5,0,8,0,13,5,8,13,0,68.2916579113,26.2660222736,42.0256356377,68.2916579113,0
2917904,Jandaíra,18,Litoral Norte e Agreste Baiano,11120,3,0,3,0,6,3,3,6,0,53.9568345324,26.9784172662,26.9784172662,53.9568345324,0
2918001,Jequié,22,Médio Rio de Contas,162209,160,56,294,12,522,216,306,454,68,321.8070513967,133.161538509,188.6455128877,279.8858263105,41.9212250862
2918100,Jeremoabo,17,Semiárido Nordeste II,41605,19,0,37,0,56,19,37,56,0,134.5992068261,45.6675880303,88.9316187958,134.5992068261,0
2918209,Jiquiriçá,9,Vale do Jiquiriçá,15106,6,0,11,0,17,6,11,17,0,112.5380643453,39.7193168278,72.8187475175,112.5380643453,0
2918308,Jitaúna,22,Médio Rio de Contas,12692,2,0,13,0,15,2,13,15,0,118.184683265,15.7579577687,102.4267254964,118.184683265,0
2918357,João Dourado,1,Irecê,25646,4,0,12,0,16,4,12,16,0,62.387896748,15.596974187,46.790922561,62.387896748,0
2918407,Juazeiro,10,Sertão do São Francisco,221773,319,130,269,2,720,449,271,588,132,324.6562926957,202.4592714172,122.1970212785,265.1359723681,59.5203203275
2918456,Jucuruçu,7,Extremo Sul,9924,4,0,10,0,14,4,10,14,0,141.0721483273,40.3063280935,100.7658202338,141.0721483273,0
2918506,Jussara,1,Irecê,16006,4,0,11,0,15,4,11,15,0,93.7148569287,24.9906285143,68.7242284143,93.7148569287,0
2918555,Jussari,5,Litoral Sul,6275,2,0,7,0,9,2,7,9,0,143.4262948207,31.8725099602,111.5537848606,143.4262948207,0
2918605,Jussiape,3,Chapada Diamantina,7066,3,0,10,0,13,3,10,13,0,183.9796207189,42.4568355505,141.5227851684,183.9796207189,0
2918704,Lafayette Coutinho,9,Vale do Jiquiriçá,3975,2,0,6,0,8,2,6,8,0,201.2578616352,50.3144654088,150.9433962264,201.2578616352,0
2918753,Lagoa Real,13,Sertão Produtivo,16029,2,0,8,0,10,2,8,10,0,62.3869237008,12.4773847402,49.9095389606,62.3869237008,0
2918803,Laje,9,Vale do Jiquiriçá,24306,15,1,17,0,33,16,17,32,1,135.7689459393,65.8273677281,69.9415782111,131.6547354563,4.114210483
2918902,Lajedão,7,Extremo Sul,4068,3,0,11,0,14,3,11,14,0,344.1494591937,73.7463126844,270.4031465093,344.1494591937,0
2919009,Lajedinho,14,Piemonte do Paraguaçu,4017,0,0,1,0,1,0,1,1,0,24.8941996515,0,24.8941996515,24.8941996515,0
2919058,Lajedo do Tabocal,9,Vale do Jiquiriçá,8886,2,0,8,0,10,2,8,10,0,112.5365743867,22.5073148773,90.0292595093,112.5365743867,0
2919108,Lamarão,4,Sisal,9007,4,0,6,0,10,4,6,10,0,111.0247585212,44.4099034085,66.6148551127,111.0247585212,0
2919157,Lapão,1,Irecê,28244,8,0,19,0,27,8,19,27,0,95.5955247132,28.324599915,67.2709247982,95.5955247132,0
2919207,Lauro de Freitas,26,Metropolitano de Salvador,197636,238,241,161,14,654,479,175,399,255,330.911372422,242.3647513611,88.5466210609,201.8862960189,129.0250764031
2919306,Lençóis,3,Chapada Diamantina,11636,6,0,7,0,13,6,7,13,0,111.72224132,51.5641113785,60.1581299416,111.72224132,0
2919405,Licínio de Almeida,20,Sudoeste Baiano,12969,2,0,12,0,14,2,12,14,0,107.9497262703,15.4213894672,92.5283368031,107.9497262703,0
2919504,Livramento de Nossa Senhora,13,Sertão Produtivo,46739,17,8,43,5,73,25,48,60,13,156.1864823809,53.4885213633,102.6979610176,128.372451272,27.8140311089
2919553,Luís Eduardo Magalhães,11,Bacia do Rio Grande,83557,46,17,52,2,117,63,54,98,19,140.024175114,75.3976327537,64.6265423603,117.2852065057,22.7389686083
2919603,Macajuba,14,Piemonte do Paraguaçu,11879,5,0,6,0,11,5,6,11,0,92.600387238,42.0910851082,50.5093021298,92.600387238,0
2919702,Macarani,8,Médio Sudoeste da Bahia,19110,5,0,15,0,20,5,15,20,0,104.6572475144,26.1643118786,78.4929356358,104.6572475144,0
2919801,Macaúbas,12,Bacia do Paramirim,50987,27,0,36,0,63,27,36,63,0,123.5609076824,52.954674721,70.6062329613,123.5609076824,0
2919900,Macururé,24,Itaparica,8266,7,0,7,0,14,7,7,14,0,169.3684974595,84.6842487297,84.6842487297,169.3684974595,0
2919926,Madre de Deus,26,Metropolitano de Salvador,21007,28,1,22,1,52,29,23,50,2,247.5365354406,138.049221688,109.4873137526,238.0158994621,9.5206359785
2919959,Maetinga,20,Sudoeste Baiano,4456,5,0,12,0,17,5,12,17,0,381.5080789946,112.2082585278,269.2998204668,381.5080789946,0
2920007,Maiquinique,8,Médio Sudoeste da Bahia,10274,3,0,7,0,10,3,7,10,0,97.3330737785,29.1999221335,68.1331516449,97.3330737785,0
2920106,Mairi,15,Bacia do Jacuípe,19695,10,1,25,0,36,11,25,35,1,182.7875095202,55.8517390201,126.9357705001,177.7100787002,5.07743082
2920205,Malhada,2,Velho Chico,17526,6,0,9,0,15,6,9,15,0,85.587127696,34.2348510784,51.3522766176,85.587127696,0
2920304,Malhada de Pedras,13,Sertão Produtivo,8856,0,0,6,0,6,0,6,6,0,67.7506775068,0,67.7506775068,67.7506775068,0
2920403,Manoel Vitorino,22,Médio Rio de Contas,14251,2,0,16,0,18,2,16,18,0,126.3069258298,14.03410287,112.2728229598,126.3069258298,0
2920452,Mansidão,11,Bacia do Rio Grande,13959,5,0,6,0,11,5,6,11,0,78.8022064618,35.8191847554,42.9830217064,78.8022064618,0
2920502,Maracás,9,Vale do Jiquiriçá,23018,8,0,20,0,28,8,20,28,0,121.6439308367,34.7554088105,86.8885220262,121.6439308367,0
2920601,Maragogipe,21,Recôncavo,46260,10,1,20,0,31,11,20,30,1,67.0125378297,23.7786424557,43.233895374,64.850843061,2.1616947687
2920700,Maraú,5,Litoral Sul,21313,7,0,14,0,21,7,14,21,0,98.5314127528,32.8438042509,65.6876085019,98.5314127528,0
2920809,Marcionílio Souza,3,Chapada Diamantina,10931,2,0,3,0,5,2,3,5,0,45.741469216,18.2965876864,27.4448815296,45.741469216,0
2920908,Mascote,5,Litoral Sul,14728,5,0,13,0,18,5,13,18,0,122.216186855,33.948940793,88.2672460619,122.216186855,0
2921005,Mata de São João,26,Metropolitano de Salvador,46998,27,3,26,1,57,30,27,53,4,121.2817566705,63.8325035108,57.4492531597,112.7707562024,8.5110004681
2921054,Matina,2,Velho Chico,12488,3,0,8,0,11,3,8,11,0,88.0845611787,24.0230621397,64.0614990391,88.0845611787,0
2921104,Medeiros Neto,7,Extremo Sul,23586,17,0,21,0,38,17,21,38,0,161.1125243789,72.0766556432,89.0358687357,161.1125243789,0
2921203,Miguel Calmon,16,Piemonte da Diamantina,27520,15,2,26,0,43,17,26,41,2,156.25,61.773255814,94.476744186,148.9825581395,7.2674418605
2921302,Milagres,9,Vale do Jiquiriçá,11585,4,0,7,0,11,4,7,11,0,94.9503668537,34.5274061286,60.4229607251,94.9503668537,0
2921401,Mirangaba,16,Piemonte da Diamantina,18729,4,0,10,0,14,4,10,14,0,74.7503871002,21.3572534572,53.393133643,74.7503871002,0
2921450,Mirante,20,Sudoeste Baiano,9578,3,0,6,0,9,3,6,9,0,93.9653372312,31.3217790771,62.6435581541,93.9653372312,0
2921500,Monte Santo,4,Sisal,51953,24,0,15,0,39,24,15,39,0,75.0678497873,46.1955998691,28.8722499182,75.0678497873,0
2921609,Morpará,2,Velho Chico,8950,4,0,5,0,9,4,5,9,0,100.5586592179,44.6927374302,55.8659217877,100.5586592179,0
2921708,Morro do Chapéu,3,Chapada Diamantina,36856,26,0,27,0,53,26,27,53,0,143.8029086173,70.5448230953,73.258085522,143.8029086173,0
2921807,Mortugaba,20,Sudoeste Baiano,12529,7,1,13,1,22,8,14,20,2,175.5926251097,63.8518636763,111.7407614335,159.6296591907,15.9629659191
2921906,Mucugê,3,Chapada Diamantina,9957,6,0,18,0,24,6,18,24,0,241.0364567641,60.259114191,180.7773425731,241.0364567641,0
2922003,Mucuri,7,Extremo Sul,42072,44,8,28,0,80,52,28,72,8,190.1502186728,123.5976421373,66.5525765355,171.1351968055,19.0150218673
2922052,Mulungu do Morro,1,Irecê,11988,3,0,8,0,11,3,8,11,0,91.7584250918,25.025025025,66.7334000667,91.7584250918,0
2922102,Mundo Novo,14,Piemonte do Paraguaçu,27364,9,0,12,0,21,9,12,21,0,76.7431662038,32.889928373,43.8532378307,76.7431662038,0
2922201,Muniz Ferreira,21,Recôncavo,7678,5,0,7,0,12,5,7,12,0,156.2907007033,65.121125293,91.1695754103,156.2907007033,0
2922250,Muquém do São Francisco,2,Velho Chico,11644,2,0,8,0,10,2,8,10,0,85.8811405015,17.1762281003,68.7049124012,85.8811405015,0
2922300,Muritiba,21,Recôncavo,30631,13,4,25,0,42,17,25,38,4,137.1159936013,55.4993307434,81.6166628579,124.057327544,13.0586660573
2922409,Mutuípe,9,Vale do Jiquiriçá,22998,5,3,18,0,26,8,18,23,3,113.0533089834,34.7856335334,78.26767545,100.0086964084,13.044612575
2922508,Nazaré,21,Recôncavo,29546,21,4,31,0,56,25,31,52,4,189.5349624315,84.613822514,104.9211399174,175.9967508292,13.5382116022
2922607,Nilo Peçanha,6,Baixo Sul,14368,4,0,12,0,16,4,12,16,0,111.3585746102,27.8396436526,83.5189309577,111.3585746102,0
2922656,Nordestina,4,Sisal,13597,4,0,12,0,16,4,12,16,0,117.6730161065,29.4182540266,88.2547620799,117.6730161065,0
2922706,Nova Canaã,8,Médio Sudoeste da Bahia,17141,7,0,14,0,21,7,14,21,0,122.5132722712,40.8377574237,81.6755148474,122.5132722712,0
2922730,Nova Fátima,15,Bacia do Jacuípe,8119,3,2,7,1,13,5,8,10,3,160.1182411627,61.5839389087,98.534302254,123.1678778175,36.9503633452
2922755,Nova Ibiá,22,Médio Rio de Contas,6986,1,0,7,0,8,1,7,8,0,114.5147437733,14.3143429717,100.2004008016,114.5147437733,0
2922805,Nova Itarana,9,Vale do Jiquiriçá,8428,3,0,5,0,8,3,5,8,0,94.9216896061,35.5956336023,59.3260560038,94.9216896061,0
2922854,Nova Redenção,3,Chapada Diamantina,9500,4,0,4,0,8,4,4,8,0,84.2105263158,42.1052631579,42.1052631579,84.2105263158,0
2922904,Nova Soure,17,Semiárido Nordeste II,25460,10,1,17,0,28,11,17,27,1,109.9764336214,43.2050274941,66.7714061273,106.0487038492,3.9277297722
2923001,Nova Viçosa,7,Extremo Sul,44052,22,0,27,0,49,22,27,49,0,111.2321801507,49.9409788432,61.2912013075,111.2321801507,0
2923035,Novo Horizonte,3,Chapada Diamantina,12514,4,0,6,0,10,4,6,10,0,79.9105002397,31.9642000959,47.9463001438,79.9105002397,0
2923050,Novo Triunfo,17,Semiárido Nordeste II,16037,4,0,5,0,9,4,5,9,0,56.1202219867,24.942320883,31.1779011037,56.1202219867,0
2923100,Olindina,18,Litoral Norte e Agreste Baiano,29227,7,1,16,0,24,8,16,23,1,82.1158517809,27.3719505936,54.7439011873,78.6943579567,3.4214938242
2923209,Oliveira dos Brejinhos,2,Velho Chico,22805,7,0,12,0,19,7,12,19,0,83.3150624863,30.6950230213,52.620039465,83.3150624863,0
2923308,Ouriçangas,18,Litoral Norte e Agreste Baiano,8916,4,0,4,0,8,4,4,8,0,89.7263346792,44.8631673396,44.8631673396,89.7263346792,0
2923357,Ourolândia,16,Piemonte da Diamantina,18025,7,2,12,1,22,9,13,19,3,122.052704577,49.9306518724,72.1220527046,105.4091539528,16.6435506241
2923407,Palmas de Monte Alto,13,Sertão Produtivo,22553,8,0,10,0,18,8,10,18,0,79.8119984038,35.4719992906,44.3399991132,79.8119984038,0
2923506,Palmeiras,3,Chapada Diamantina,9250,9,0,6,1,16,9,7,15,1,172.972972973,97.2972972973,75.6756756757,162.1621621622,10.8108108108
2923605,Paramirim,12,Bacia do Paramirim,22286,18,6,36,4,64,24,40,54,10,287.1758054384,107.6909270394,179.484878399,242.3045858386,44.8712195997
2923704,Paratinga,2,Velho Chico,32967,12,0,15,0,27,12,15,27,0,81.9000819001,36.4000364,45.5000455,81.9000819001,0
2923803,Paripiranga,17,Semiárido Nordeste II,30075,10,2,15,0,27,12,15,25,2,89.7755610973,39.9002493766,49.8753117207,83.1255195345,6.6500415628
2923902,Pau-Brasil,5,Litoral Sul,10673,6,0,13,0,19,6,13,19,0,178.01930104,56.2166213811,121.802679659,178.01930104,0
2924009,Paulo Afonso,24,Itaparica,120706,107,46,87,4,244,153,91,194,50,202.1440524912,126.7542624227,75.3897900684,160.7210909151,41.4229615761
2924058,Pé de Serra,15,Bacia do Jacuípe,14226,8,1,14,0,23,9,14,22,1,161.6758048643,63.2644453817,98.4113594826,154.6464220441,7.0293828202
2924108,Pedrão,18,Litoral Norte e Agreste Baiano,7527,2,0,5,0,7,2,5,7,0,92.9985385944,26.571011027,66.4275275674,92.9985385944,0
2924207,Pedro Alexandre,17,Semiárido Nordeste II,18209,7,0,10,0,17,7,10,17,0,93.3604261629,38.44252842,54.9178977429,93.3604261629,0
2924306,Piatã,3,Chapada Diamantina,18267,10,1,12,0,23,11,12,22,1,125.9101111294,60.2178792358,65.6922318936,120.4357584716,5.4743526578
2924405,Pilão Arcado,10,Sertão do São Francisco,35740,8,0,13,0,21,8,13,21,0,58.75769446,22.3838836038,36.3738108562,58.75769446,0
2924504,Pindaí,13,Sertão Produtivo,16889,2,0,10,0,12,2,10,12,0,71.0521641305,11.8420273551,59.2101367754,71.0521641305,0
2924603,Pindobaçu,25,Piemonte Norte do Itapicuru,21171,10,0,8,0,18,10,8,18,0,85.0219640074,47.2344244485,37.7875395588,85.0219640074,0
2924652,Pintadas,15,Bacia do Jacuípe,11012,5,0,6,0,11,5,6,11,0,99.8910279695,45.4050127134,54.4860152561,99.8910279695,0
2924678,Piraí do Norte,6,Baixo Sul,10411,2,0,6,0,8,2,6,8,0,76.8418019403,19.2104504851,57.6313514552,76.8418019403,0
2924702,Piripá,20,Sudoeste Baiano,11849,6,0,17,0,23,6,17,23,0,194.1092075281,50.6371845725,143.4720229555,194.1092075281,0
2924801,Piritiba,14,Piemonte do Paraguaçu,25211,8,0,9,0,17,8,9,17,0,67.4308833446,31.7321803974,35.6987029471,67.4308833446,0
2924900,Planaltino,9,Vale do Jiquiriçá,9582,2,0,6,0,8,2,6,8,0,83.4898768524,20.8724692131,62.6174076393,83.4898768524,0
2925006,Planalto,20,Sudoeste Baiano,26915,7,0,18,0,25,7,18,25,0,92.8850083597,26.0078023407,66.8772060189,92.8850083597,0
2925105,Poções,20,Sudoeste Baiano,48861,17,7,40,0,64,24,40,57,7,130.9838112196,49.1189292073,81.8648820122,116.6574568674,14.3263543521
2925204,Pojuca,26,Metropolitano de Salvador,39718,29,5,37,1,72,34,38,66,6,181.2780099703,85.6035047082,95.6745052621,166.1715091394,15.1065008309
2925253,Ponto Novo,25,Piemonte Norte do Itapicuru,15830,2,0,2,0,4,2,2,4,0,25.2684775742,12.6342387871,12.6342387871,25.2684775742,0
2925303,Porto Seguro,27,Costa do Descobrimento,149324,96,34,156,3,289,130,159,252,37,193.5388818944,87.0590126169,106.4798692775,168.7605475342,24.7783343602
2925402,Potiraguá,8,Médio Sudoeste da Bahia,8438,2,0,8,0,10,2,8,10,0,118.5114956151,23.702299123,94.8091964921,118.5114956151,0
2925501,Prado,7,Extremo Sul,29326,15,1,29,0,45,16,29,44,1,153.4474527723,54.559094319,98.8883584532,150.0375093773,3.4099433949
2925600,Presidente Dutra,1,Irecê,15734,5,0,15,0,20,5,15,20,0,127.1132579128,31.7783144782,95.3349434346,127.1132579128,0
2925709,Presidente Jânio Quadros,20,Sudoeste Baiano,13334,8,0,12,1,21,8,13,20,1,157.4921253937,59.99700015,97.4951252437,149.992500375,7.4996250187
2925758,Presidente Tancredo Neves,6,Baixo Sul,28082,9,3,17,0,29,12,17,26,3,103.2689979346,42.7319991454,60.5369987893,92.5859981483,10.6829997863
2925808,Queimadas,4,Sisal,26552,4,1,14,0,19,5,14,18,1,71.5576981018,18.8309731847,52.7267249171,67.7915034649,3.7661946369
2925907,Quijingue,4,Sisal,28632,12,0,17,0,29,12,17,29,0,101.2852752165,41.9111483655,59.3741268511,101.2852752165,0
2925931,Quixabeira,15,Bacia do Jacuípe,9411,2,0,6,0,8,2,6,8,0,85.0069068112,21.2517267028,63.7551801084,85.0069068112,0
2925956,Rafael Jambeiro,14,Piemonte do Paraguaçu,23562,6,0,23,0,29,6,23,29,0,123.0795348442,25.4647313471,97.6148034972,123.0795348442,0
2926004,Remanso,10,Sertão do São Francisco,42672,27,5,25,1,58,32,26,52,6,135.9205099363,74.9906261717,60.9298837645,121.8597675291,14.0607424072
2926103,Retirolândia,4,Sisal,14730,12,0,10,0,22,12,10,22,0,149.3550577054,81.466395112,67.8886625933,149.3550577054,0
2926202,Riachão das Neves,11,Bacia do Rio Grande,23313,7,0,17,0,24,7,17,24,0,102.9468536868,30.0261656586,72.9206880281,102.9468536868,0
2926301,Riachão do Jacuípe,15,Bacia do Jacuípe,34784,16,1,29,4,50,17,33,45,5,143.74425023,48.8730450782,94.8712051518,129.369825207,14.374425023
2926400,Riacho de Santana,2,Velho Chico,36439,9,0,22,0,31,9,22,31,0,85.0736847883,24.6988117127,60.3748730756,85.0736847883,0
2926509,Ribeira do Amparo,17,Semiárido Nordeste II,15443,7,0,13,0,20,7,13,20,0,129.5085151849,45.3279803147,84.1805348702,129.5085151849,0
2926608,Ribeira do Pombal,17,Semiárido Nordeste II,54965,28,4,50,1,83,32,51,78,5,151.0051851178,58.2188665514,92.7863185664,141.9084872191,9.0966978987
2926657,Ribeirão do Largo,20,Sudoeste Baiano,7437,3,0,8,0,11,3,8,11,0,147.909103133,40.338846309,107.570256824,147.909103133,0
2926707,Rio de Contas,3,Chapada Diamantina,13712,1,0,11,0,12,1,11,12,0,87.5145857643,7.292882147,80.2217036173,87.5145857643,0
2926806,Rio do Antônio,13,Sertão Produtivo,15804,6,0,7,0,13,6,7,13,0,82.2576562895,37.9650721336,44.2925841559,82.2576562895,0
2926905,Rio do Pires,12,Bacia do Paramirim,12130,5,0,8,0,13,5,8,13,0,107.1723000824,41.2201154163,65.9521846661,107.1723000824,0
2927002,Rio Real,18,Litoral Norte e Agreste Baiano,41767,12,0,18,0,30,12,18,30,0,71.8270404865,28.7308161946,43.0962242919,71.8270404865,0
2927101,Rodelas,24,Itaparica,9405,7,0,9,0,16,7,9,16,0,170.1222753854,74.4284954811,95.6937799043,170.1222753854,0
2927200,Ruy Barbosa,14,Piemonte do Paraguaçu,32009,19,0,27,0,46,19,27,46,0,143.7095816802,59.3583054766,84.3512762036,143.7095816802,0
2927309,Salinas da Margarida,21,Recôncavo,15772,4,0,14,0,18,4,14,18,0,114.1262997717,25.3613999493,88.7648998225,114.1262997717,0
2927408,Salvador,26,Metropolitano de Salvador,2953986,6391,1575,4716,649,13331,7966,5365,11107,2224,451.288530142,269.6695245001,181.6190056419,376.0004278964,75.2881022456
2927507,Santa Bárbara,19,Portal do Sertão,21415,5,2,13,0,20,7,13,18,2,93.3924819052,32.6873686668,60.7051132384,84.0532337147,9.3392481905
2927606,Santa Brígida,17,Semiárido Nordeste II,14976,3,0,9,0,12,3,9,12,0,80.1282051282,20.0320512821,60.0961538462,80.1282051282,0
2927705,Santa Cruz Cabrália,27,Costa do Descobrimento,28552,13,0,21,0,34,13,21,34,0,119.080975063,45.5309610535,73.5500140095,119.080975063,0
2927804,Santa Cruz da Vitória,8,Médio Sudoeste da Bahia,6698,3,0,6,0,9,3,6,9,0,134.3684681995,44.7894893998,89.5789787996,134.3684681995,0
2927903,Santa Inês,9,Vale do Jiquiriçá,11161,3,1,9,0,13,4,9,12,1,116.4770181883,35.8390825195,80.6379356688,107.5172475585,8.9597706299
2928000,Santaluz,4,Sisal,38422,22,1,34,2,59,23,36,56,3,153.5578574775,59.8615376607,93.6963198168,145.7498308261,7.8080266514
2928059,Santa Luzia,5,Litoral Sul,13398,1,0,8,0,9,1,8,9,0,67.1742051052,7.4638005672,59.710404538,67.1742051052,0
2928109,Santa Maria da Vitória,23,Bacia do Rio Corrente,41769,25,2,31,0,58,27,31,56,2,138.8589623884,64.6412411118,74.2177212765,134.070722306,4.7882400824
2928208,Santana,23,Bacia do Rio Corrente,27492,12,0,12,0,24,12,12,24,0,87.2981230904,43.6490615452,43.6490615452,87.2981230904,0
2928307,Santanópolis,19,Portal do Sertão,9263,3,0,6,0,9,3,6,9,0,97.1607470582,32.3869156861,64.7738313721,97.1607470582,0
2928406,Santa Rita de Cássia,11,Bacia do Rio Grande,29146,13,0,25,0,38,13,25,38,0,130.3780964798,44.6030330062,85.7750634735,130.3780964798,0
2928505,Santa Terezinha,14,Piemonte do Paraguaçu,10682,3,0,8,0,11,3,8,11,0,102.9769706048,28.0846283468,74.892342258,102.9769706048,0
2928604,Santo Amaro,21,Recôncavo,61961,31,5,47,0,83,36,47,78,5,133.9552299027,58.1010635722,75.8541663304,125.8856377399,8.0695921628
2928703,Santo Antônio de Jesus,21,Recôncavo,103342,94,31,96,39,260,125,135,190,70,251.5918019779,120.9575971048,130.6342048731,183.8555475992,67.7362543787
2928802,Santo Estevão,19,Portal do Sertão,53898,19,2,29,0,50,21,29,48,2,92.7678206984,38.9624846933,53.805336005,89.0571078704,3.7107128279
2928901,São Desidério,11,Bacia do Rio Grande,33661,6,0,19,0,25,6,19,25,0,74.2699266213,17.8247823891,56.4451442322,74.2699266213,0
2928950,São Domingos,4,Sisal,9404,7,0,5,0,12,7,5,12,0,127.6052743513,74.4364100383,53.1688643131,127.6052743513,0
2929008,São Félix,21,Recôncavo,15310,26,0,22,0,48,26,22,48,0,313.5205747877,169.8236446767,143.696930111,313.5205747877,0
2929057,São Félix do Coribe,23,Bacia do Rio Corrente,15825,8,0,14,0,22,8,14,22,0,139.0205371248,50.5529225908,88.467614534,139.0205371248,0
2929107,São Felipe,21,Recôncavo,21964,6,1,18,0,25,7,18,24,1,113.8226188308,31.8703332726,81.9522855582,109.2697140776,4.5529047532
2929206,São Francisco do Conde,26,Metropolitano de Salvador,40220,24,5,66,0,95,29,66,90,5,236.2008950771,72.1034311288,164.0974639483,223.7692690204,12.4316260567
2929255,São Gabriel,1,Irecê,19613,4,0,9,0,13,4,9,13,0,66.2825676847,20.3946362107,45.887931474,66.2825676847,0
2929305,São Gonçalo dos Campos,19,Portal do Sertão,38018,8,1,15,0,24,9,15,23,1,63.1279920038,23.6729970014,39.4549950024,60.4976590036,2.6303330002
2929354,São José da Vitória,5,Litoral Sul,6045,1,0,4,0,5,1,4,5,0,82.7129859388,16.5425971878,66.170388751,82.7129859388,0
2929370,São José do Jacuípe,15,Bacia do Jacuípe,10784,2,0,7,0,9,2,7,9,0,83.4569732938,18.5459940653,64.9109792285,83.4569732938,0
2929404,São Miguel das Matas,9,Vale do Jiquiriçá,12092,3,0,5,0,8,3,5,8,0,66.1594442607,24.8097915978,41.3496526629,66.1594442607,0
2929503,São Sebastião do Passé,26,Metropolitano de Salvador,45827,22,3,32,0,57,25,32,54,3,124.380823532,54.5529927772,69.8278307548,117.8344643987,6.5463591333
2929602,Sapeaçu,21,Recôncavo,18114,6,0,22,0,28,6,22,28,0,154.5765706084,33.1235508447,121.4530197637,154.5765706084,0
2929701,Sátiro Dias,18,Litoral Norte e Agreste Baiano,20429,6,0,15,0,21,6,15,21,0,102.7950462578,29.3700132165,73.4250330413,102.7950462578,0
2929750,Saubara,21,Recôncavo,12380,2,0,7,0,9,2,7,9,0,72.6978998384,16.155088853,56.5428109855,72.6978998384,0
2929800,Saúde,16,Piemonte da Diamantina,13385,4,0,8,0,12,4,8,12,0,89.6525961898,29.8841987299,59.7683974598,89.6525961898,0
2929909,Seabra,3,Chapada Diamantina,45568,26,4,41,1,72,30,42,67,5,158.0056179775,65.8356741573,92.1699438202,147.033005618,10.9726123596
2930006,Sebastião Laranjeiras,13,Sertão Produtivo,11696,4,0,10,0,14,4,10,14,0,119.6990424077,34.1997264022,85.4993160055,119.6990424077,0
2930105,Senhor do Bonfim,25,Piemonte Norte do Itapicuru,81218,27,14,32,2,75,41,34,59,16,92.3440616612,50.4814203748,41.8626412864,72.6439951735,19.7000664877
2930154,Serra do Ramalho,2,Velho Chico,32991,8,0,15,0,23,8,15,23,0,69.7159831469,24.2490376163,45.4669455306,69.7159831469,0
2930204,Sento Sé,10,Sertão do São Francisco,41891,13,0,17,0,30,13,17,30,0,71.6144279201,31.0329187654,40.5815091547,71.6144279201,0
2930303,Serra Dourada,23,Bacia do Rio Corrente,18320,7,0,12,0,19,7,12,19,0,103.711790393,38.2096069869,65.5021834061,103.711790393,0
2930402,Serra Preta,15,Bacia do Jacuípe,16036,3,0,10,0,13,3,10,13,0,81.0675979047,18.7079072088,62.3596906959,81.0675979047,0
2930501,Serrinha,4,Sisal,83088,32,14,72,3,121,46,75,104,17,145.628730984,55.3629886386,90.2657423455,125.1684960524,20.4602349316
2930600,Serrolândia,16,Piemonte da Diamantina,13832,6,0,9,0,15,6,9,15,0,108.4441873916,43.3776749566,65.0665124349,108.4441873916,0
2930709,Simões Filho,26,Metropolitano de Salvador,136050,69,6,62,2,139,75,64,131,8,102.1683204704,55.1267916207,47.0415288497,96.2881293642,5.8801911062
2930758,Sítio do Mato,2,Velho Chico,13437,6,0,12,0,18,6,12,18,0,133.9584728734,44.6528242911,89.3056485823,133.9584728734,0
2930766,Sítio do Quinto,17,Semiárido Nordeste II,11283,6,0,7,1,14,6,8,13,1,124.080475051,53.1773464504,70.9031286005,115.2175839759,8.8628910751
2930774,Sobradinho,10,Sertão do São Francisco,23713,9,1,10,0,20,10,10,19,1,84.3419221524,42.1709610762,42.1709610762,80.1248260448,4.2170961076
2930808,Souto Soares,3,Chapada Diamantina,17503,1,0,8,0,9,1,8,9,0,51.4197566132,5.7133062904,45.7064503228,51.4197566132,0
2930907,Tabocas do Brejo Velho,23,Bacia do Rio Corrente,13057,1,0,10,0,11,1,10,11,0,84.2459983151,7.6587271196,76.5872711955,84.2459983151,0
2931004,Tanhaçu,13,Sertão Produtivo,21315,11,1,17,0,29,12,17,28,1,136.0544217687,56.2983814215,79.7560403472,131.3628899836,4.6915317851
2931053,Tanque Novo,13,Sertão Produtivo,17884,5,0,12,0,17,5,12,17,0,95.0570342205,27.9579512413,67.0990829792,95.0570342205,0
2931103,Tanquinho,19,Portal do Sertão,8232,1,0,6,0,7,1,6,7,0,85.0340136054,12.1477162293,72.8862973761,85.0340136054,0
2931202,Taperoá,6,Baixo Sul,21462,11,0,11,0,22,11,11,22,0,102.5067561271,51.2533780636,51.2533780636,102.5067561271,0
2931301,Tapiramutá,14,Piemonte do Paraguaçu,17845,6,0,5,0,11,6,5,11,0,61.6419165032,33.6228635472,28.019052956,61.6419165032,0
2931350,Teixeira de Freitas,7,Extremo Sul,161690,153,56,118,24,351,209,142,271,80,217.082070629,129.2596944771,87.8223761519,167.6046756138,49.4773950152
2931400,Teodoro Sampaio,19,Portal do Sertão,7936,6,1,7,0,14,7,7,13,1,176.4112903226,88.2056451613,88.2056451613,163.810483871,12.6008064516
2931509,Teofilândia,4,Sisal,23378,10,1,13,0,24,11,13,23,1,102.6606210968,47.0527846693,55.6078364274,98.3830952177,4.277525879
2931608,Teolândia,6,Baixo Sul,15357,5,0,14,0,19,5,14,19,0,123.7220811356,32.5584424041,91.1636387315,123.7220811356,0
2931707,Terra Nova,19,Portal do Sertão,13536,6,0,9,0,15,6,9,15,0,110.8156028369,44.3262411348,66.4893617021,110.8156028369,0
2931806,Tremedal,20,Sudoeste Baiano,17700,10,0,20,0,30,10,20,30,0,169.4915254237,56.4971751412,112.9943502825,169.4915254237,0
2931905,Tucano,4,Sisal,52540,25,0,34,0,59,25,34,59,0,112.2953939855,47.5827940617,64.7125999239,112.2953939855,0
2932002,Uauá,10,Sertão do São Francisco,25773,9,2,6,0,17,11,6,15,2,65.9605012998,42.6803243705,23.2801769293,58.2004423234,7.7600589764
2932101,Ubaíra,9,Vale do Jiquiriçá,20800,8,0,14,0,22,8,14,22,0,105.7692307692,38.4615384615,67.3076923077,105.7692307692,0
2932200,Ubaitaba,5,Litoral Sul,20489,7,0,15,0,22,7,15,22,0,107.3746888574,34.1646737274,73.2100151301,107.3746888574,0
2932309,Ubatã,22,Médio Rio de Contas,27527,3,0,14,0,17,3,14,17,0,61.7575471355,10.898390671,50.8591564646,61.7575471355,0
2932408,Uibaí,1,Irecê,14474,4,0,8,0,12,4,8,12,0,82.9072820229,27.6357606743,55.2715213486,82.9072820229,0
2932457,Umburanas,16,Piemonte da Diamantina,19522,4,0,9,0,13,4,9,13,0,66.5915377523,20.4897039238,46.1018338285,66.5915377523,0
2932507,Una,5,Litoral Sul,21331,8,0,32,0,40,8,32,40,0,187.5205100558,37.5041020112,150.0164080446,187.5205100558,0
2932606,Urandi,13,Sertão Produtivo,17356,5,1,10,0,16,6,10,15,1,92.187139894,34.5701774602,57.6169624337,86.4254436506,5.7616962434
2932705,Uruçuca,5,Litoral Sul,21711,9,0,10,0,19,9,10,19,0,87.5132421353,41.4536410115,46.0596011239,87.5132421353,0
2932804,Utinga,3,Chapada Diamantina,19780,4,0,10,0,14,4,10,14,0,70.7785642063,20.2224469161,50.5561172902,70.7785642063,0
2932903,Valença,6,Baixo Sul,98749,36,12,50,6,104,48,56,86,18,105.3175222028,48.6080871705,56.7094350323,87.0894895138,18.2280326889
2933000,Valente,4,Sisal,28743,9,0,14,0,23,9,14,23,0,80.0194830046,31.3119716105,48.7075113941,80.0194830046,0
2933059,Várzea da Roça,15,Bacia do Jacuípe,14662,5,0,6,0,11,5,6,11,0,75.0238712318,34.1017596508,40.922111581,75.0238712318,0
2933109,Várzea do Poço,15,Bacia do Jacuípe,9449,2,0,6,0,8,2,6,8,0,84.66504392,21.16626098,63.49878294,84.66504392,0
2933158,Várzea Nova,16,Piemonte da Diamantina,13454,5,0,10,0,15,5,10,15,0,111.4910063922,37.1636687974,74.3273375948,111.4910063922,0
2933174,Varzedo,21,Recôncavo,9375,3,0,11,0,14,3,11,14,0,149.3333333333,32,117.3333333333,149.3333333333,0
2933208,Vera Cruz,26,Metropolitano de Salvador,43640,10,0,37,0,47,10,37,47,0,107.6993583868,22.9147571036,84.7846012832,107.6993583868,0
2933257,Vereda,7,Extremo Sul,6620,4,0,8,0,12,4,8,12,0,181.2688821752,60.4229607251,120.8459214502,181.2688821752,0
2933307,Vitória da Conquista,20,Sudoeste Baiano,348718,443,176,314,46,979,619,360,757,222,280.7426057731,177.5073268372,103.235278936,217.0808504293,63.6617553439
2933406,Wagner,3,Chapada Diamantina,9753,4,0,6,0,10,4,6,10,0,102.5325540859,41.0130216344,61.5195324516,102.5325540859,0
2933455,Wanderley,11,Bacia do Rio Grande,12935,6,0,11,0,17,6,11,17,0,131.4263625821,46.385775029,85.0405875532,131.4263625821,0
2933505,Wenceslau Guimarães,6,Baixo Sul,22365,7,0,19,0,26,7,19,26,0,116.2530739996,31.2989045383,84.9541694612,116.2530739996,0
2933604,Xique-Xique,1,Irecê,48365,9,0,19,0,28,9,19,28,0,57.8931045177,18.6084978807,39.284606637,57.8931045177,0
