Código,Município,Código TI,Território de Identidade,População,QtMédicosSUS,QtMédicosNãoSUS,QtEnfermeirosSUS,QtEnfermeirosNãoSUS,QtProfissionais,Médicos,Enfermeiros,SUS,Não SUS,QtProfissionais/100000Hab,QtMédicos/100000Hab,QtEnfermeiros/100000Hab,QtSUS/100000Hab,QtNãoSUS/100000Hab
2900108,Abaíra,3,Chapada Diamantina,9199,4,0,7,0,11,4,7,11,0,119.5782150234,43.4829872812,76.0952277421,119.5782150234,0
2900207,Abaré,24,Itaparica,20189,9,0,19,0,28,9,19,28,0,138.6893853088,44.5787309921,94.1106543167,138.6893853088,0
2900306,Acajutiba,18,Litoral Norte e Agreste Baiano,15727,9,2,12,0,23,11,12,21,2,146.2453106123,69.9434094233,76.301901189,133.5283270808,12.7169835315
2900355,Adustina,17,Semiárido Nordeste II,17349,7,0,9,1,17,7,10,16,1,97.9883566776,40.3481468673,57.6402098104,92.2243356966,5.764020981
2900405,Água Fria,19,Portal do Sertão,17508,8,0,15,0,23,8,15,23,0,131.3685172493,45.6933973041,85.6751199452,131.3685172493,0
2900504,Érico Cardoso,12,Bacia do Paramirim,11212,6,0,13,0,19,6,13,19,0,169.4612914734,53.5140920442,115.9471994292,169.4612914734,0
2900603,Aiquara,22,Médio Rio de Contas,4725,2,0,7,0,9,2,7,9,0,190.4761904762,42.328042328,148.1481481481,190.4761904762,0
2900702,Alagoinhas,18,Litoral Norte e Agreste Baiano,155979,171,121,179,24,495,292,203,350,145,317.3504125555,187.2046878105,130.145724745,224.3891805948,92.9612319607
2900801,Alcobaça,7,Extremo Sul,23376,21,0,20,0,41,21,20,41,0,175.3935660507,89.8357289528,85.5578370979,175.3935660507,0
2900900,Almadina,5,Litoral Sul,5985,5,0,5,0,10,5,5,10,0,167.0843776107,83.5421888053,83.5421888053,167.0843776107,0
2901007,Amargosa,9,Vale do Jiquiriçá,38259,24,11,39,0,74,35,39,63,11,193.4185420424,91.4817428579,101.9367991845,164.6671371442,28.7514048982
2901106,Amélia Rodrigues,19,Portal do Sertão,26409,18,1,18,0,37,19,18,36,1,140.1037525086,71.9451702071,68.1585823015,136.317164603,3.7865879056
2901155,América Dourada,1,Irecê,16798,15,0,20,0,35,15,20,35,0,208.3581378736,89.296344803,119.0617930706,208.3581378736,0
2901205,Anagé,20,Sudoeste Baiano,19568,16,0,22,0,38,16,22,38,0,194.1946034342,81.7661488144,112.4284546198,194.1946034342,0
2901304,Andaraí,3,Chapada Diamantina,13737,11,0,9,0,20,11,9,20,0,145.5921962583,80.0757079421,65.5164883162,145.5921962583,0
2901353,Andorinha,25,Piemonte Norte do Itapicuru,15490,4,3,10,0,17,7,10,14,3,109.7482246611,45.1904454487,64.5577792124,90.3808908974,19.3673337637
2901403,Angical,11,Bacia do Rio Grande,14690,5,0,12,0,17,5,12,17,0,115.7249829816,34.0367597005,81.6882232811,115.7249829816,0
2901502,Anguera,19,Portal do Sertão,11481,5,0,13,0,18,5,13,18,0,156.7807682258,43.550213396,113.2305548297,156.7807682258,0
2901601,Antas,17,Semiárido Nordeste II,19569,13,0,20,0,33,13,20,33,0,168.6340640809,66.4316010016,102.2024630794,168.6340640809,0
2901700,Antônio Cardoso,19,Portal do Sertão,12208,4,0,11,0,15,4,11,15,0,122.870249017,32.7653997379,90.1048492792,122.870249017,0
2901809,Antônio Gonçalves,25,Piemonte Norte do Itapicuru,12072,3,0,10,0,13,3,10,13,0,107.6872100729,24.8508946322,82.8363154407,107.6872100729,0
2901908,Aporá,18,Litoral Norte e Agreste Baiano,18334,9,0,6,0,15,9,6,15,0,81.8152067198,49.0891240319,32.7260826879,81.8152067198,0
2901957,Apuarema,22,Médio Rio de Contas,7730,5,0,7,0,12,5,7,12,0,155.2393272962,64.6830530401,90.5562742561,155.2393272962,0
2902005,Aracatu,20,Sudoeste Baiano,13962,11,0,16,0,27,11,16,27,0,193.3820369575,78.785274316,114.5967626415,193.3820369575,0
2902054,Araçás,18,Litoral Norte e Agreste Baiano,12608,9,0,6,0,15,9,6,15,0,118.9720812183,71.383248731,47.5888324873,118.9720812183,0
2902104,Araci,4,Sisal,55935,20,2,42,0,64,22,42,62,2,114.4185214982,39.331366765,75.0871547332,110.8429427014,3.5755787968
2902203,Aramari,18,Litoral Norte e Agreste Baiano,11703,2,0,6,0,8,2,6,8,0,68.3585405452,17.0896351363,51.2689054089,68.3585405452,0
2902252,Arataca,5,Litoral Sul,11661,5,0,10,0,15,5,10,15,0,128.6339078981,42.8779692994,85.7559385987,128.6339078981,0
2902302,Aratuípe,6,Baixo Sul,9171,3,0,9,0,12,3,9,12,0,130.8472358521,32.711808963,98.1354268891,130.8472358521,0
2902401,Aurelino Leal,5,Litoral Sul,12706,8,0,10,0,18,8,10,18,0,141.6653549504,62.962379978,78.7029749725,141.6653549504,0
2902500,Baianópolis,11,Bacia do Rio Grande,14323,6,0,14,0,20,6,14,20,0,139.6355512113,41.8906653634,97.7448858479,139.6355512113,0
2902609,Baixa Grande,15,Bacia do Jacuípe,21403,9,0,11,0,20,9,11,20,0,93.4448441807,42.0501798813,51.3946642994,93.4448441807,0
2902658,Banzaê,17,Semiárido Nordeste II,13765,5,0,13,0,18,5,13,18,0,130.7664366146,36.3240101707,94.4424264439,130.7664366146,0
2902708,Barra,2,Velho Chico,54915,28,0,40,0,68,28,40,68,0,123.8277337704,50.987890376,72.8398433943,123.8277337704,0
2902807,Barra da Estiva,3,Chapada Diamantina,22082,14,2,22,0,38,16,22,36,2,172.0858617879,72.4572049633,99.6286568246,163.0287111675,9.0571506204
2902906,Barra do Choça,20,Sudoeste Baiano,34121,24,1,21,0,46,25,21,45,1,134.8143372117,73.2686615281,61.5456756836,131.8835907506,2.9307464611
2903003,Barra do Mendes,1,Irecê,14560,4,0,17,0,21,4,17,21,0,144.2307692308,27.4725274725,116.7582417582,144.2307692308,0
2903102,Barra do Rocha,22,Médio Rio de Contas,6258,1,0,4,0,5,1,4,5,0,79.8977309044,15.9795461809,63.9181847236,79.8977309044,0
2903201,Barreiras,11,Bacia do Rio Grande,157638,201,84,266,5,556,285,271,467,89,352.7068346465,180.7939709968,171.9128636496,296.2483665106,56.4584681359
2903235,Barro Alto,1,Irecê,15217,6,0,7,0,13,6,7,13,0,85.4307682198,39.4295853322,46.0011828876,85.4307682198,0
2903276,Barrocas,4,Sisal,16296,7,0,13,1,21,7,14,20,1,128.8659793814,42.9553264605,85.910652921,122.7295041728,6.1364752086
2903300,Barro Preto,5,Litoral Sul,6251,5,0,7,0,12,5,7,12,0,191.9692849144,79.9872020477,111.9820828667,191.9692849144,0
2903409,Belmonte,27,Costa do Descobrimento,24013,16,0,22,0,38,16,22,38,0,158.2476158747,66.6305751052,91.6170407696,158.2476158747,0
2903508,Belo Campo,20,Sudoeste Baiano,18247,12,0,20,0,32,12,20,32,0,175.3712939113,65.7642352167,109.6070586946,175.3712939113,0
2903607,Biritinga,4,Sisal,16653,9,0,16,0,25,9,16,25,0,150.1231009428,54.0443163394,96.0787846034,150.1231009428,0
2903706,Boa Nova,22,Médio Rio de Contas,14069,4,0,10,0,14,4,10,14,0,99.5095600256,28.4313028645,71.0782571611,99.5095600256,0
2903805,Boa Vista do Tupim,14,Piemonte do Paraguaçu,19502,11,0,11,0,22,11,11,22,0,112.8089426725,56.4044713363,56.4044713363,112.8089426725,0
2903904,Bom Jesus da Lapa,2,Velho Chico,70618,63,8,80,0,151,71,80,143,8,213.8265031578,100.5409385709,113.2855645869,202.4979466991,11.3285564587
2903953,Bom Jesus da Serra,20,Sudoeste Baiano,10477,9,0,11,0,20,9,11,20,0,190.8943399828,85.9024529923,104.9918869906,190.8943399828,0
2904001,Boninal,3,Chapada Diamantina,14760,3,0,7,0,10,3,7,10,0,67.7506775068,20.325203252,47.4254742547,67.7506775068,0
2904050,Bonito,3,Chapada Diamantina,17131,8,0,10,0,18,8,10,18,0,105.0726752671,46.6989667854,58.3737084817,105.0726752671,0
2904100,Boquira,12,Bacia do Paramirim,22464,7,0,20,0,27,7,20,27,0,120.1923076923,31.160968661,89.0313390313,120.1923076923,0
2904209,Botuporã,12,Bacia do Paramirim,10898,7,0,11,0,18,7,11,18,0,165.1679207194,64.2319691687,100.9359515507,165.1679207194,0
2904308,Brejões,9,Vale do Jiquiriçá,15122,5,0,7,0,12,5,7,12,0,79.3545827272,33.0644094696,46.2901732575,79.3545827272,0
2904407,Brejolândia,23,Bacia do Rio Corrente,10833,2,0,7,0,9,2,7,9,0,83.0794793686,18.4621065264,64.6173728422,83.0794793686,0
2904506,Brotas de Macaúbas,2,Velho Chico,10974,6,0,8,0,14,6,8,14,0,127.574266448,54.6746856206,72.8995808274,127.574266448,0
2904605,Brumado,13,Sertão Produtivo,69677,76,28,75,4,183,104,79,151,32,262.6404695954,149.2601575843,113.3803120111,216.7142672618,45.9262023336
2904704,Buerarema,5,Litoral Sul,19256,7,0,16,0,23,7,16,23,0,119.443290403,36.3523057748,83.0909846282,119.443290403,0
2904753,Buritirama,11,Bacia do Rio Grande,21786,4,0,16,0,20,4,16,20,0,91.8020747269,18.3604149454,73.4416597815,91.8020747269,0
2904803,Caatiba,8,Médio Sudoeste da Bahia,7841,3,0,6,0,9,3,6,9,0,114.7812778982,38.2604259661,76.5208519322,114.7812778982,0
2904852,Cabaceiras do Paraguaçu,21,Recôncavo,19312,5,0,18,0,23,5,18,23,0,119.0969345485,25.8906379453,93.2062966031,119.0969345485,0
2904902,Cachoeira,21,Recôncavo,35139,27,8,30,0,65,35,30,57,8,184.9796522383,99.6044281283,85.37522411,162.2129258089,22.7667264293
2905008,Caculé,13,Sertão Produtivo,23817,11,19,22,1,53,30,23,33,20,222.5301255406,125.9604484192,96.5696771214,138.5564932611,83.9736322795
2905107,Caém,16,Piemonte da Diamantina,10058,9,0,7,0,16,9,7,16,0,159.0773513621,89.4810101412,69.5963412209,159.0773513621,0
2905156,Caetanos,20,Sudoeste Baiano,16106,6,0,11,0,17,6,11,17,0,105.5507264374,37.2531975661,68.2975288712,105.5507264374,0
2905206,Caetité,13,Sertão Produtivo,52853,54,11,41,2,108,65,43,95,13,204.3403401888,122.9826121507,81.3577280381,179.7438177587,24.5965224301
2905305,Cafarnaum,1,Irecê,19006,12,0,12,0,24,12,12,24,0,126.2759128696,63.1379564348,63.1379564348,126.2759128696,0
2905404,Cairu,6,Baixo Sul,18224,11,0,11,0,22,11,11,22,0,120.719929763,60.3599648815,60.3599648815,120.719929763,0
2905503,Caldeirão Grande,25,Piemonte Norte do Itapicuru,13713,6,0,8,0,14,6,8,14,0,102.0929045431,43.7541019471,58.3388025961,102.0929045431,0
2905602,Camacan,5,Litoral Sul,33310,21,1,27,0,49,22,27,48,1,147.1029720805,66.0462323627,81.0567397178,144.1008706094,3.002101471
2905701,Camaçari,26,Metropolitano de Salvador,296893,431,145,279,29,884,576,308,710,174,297.7503679777,194.009289542,103.7410784357,239.1433950952,58.6069728825
2905800,Camamu,6,Baixo Sul,36644,15,6,26,0,47,21,26,41,6,128.2611068661,57.3081541316,70.9529527344,111.8873485427,16.3737583233
2905909,Campo Alegre de Lourdes,10,Sertão do São Francisco,30048,8,0,17,1,26,8,18,25,1,86.5282215122,26.6240681576,59.9041533546,83.2002129925,3.3280085197
2906006,Campo Formoso,25,Piemonte Norte do Itapicuru,73448,43,9,36,0,88,52,36,79,9,119.8126565734,70.7983879752,49.0142685982,107.5590894238,12.2535671495
2906105,Canápolis,23,Bacia do Rio Corrente,10151,5,0,8,0,13,5,8,13,0,128.0662003743,49.2562309132,78.8099694611,128.0662003743,0
2906204,Canarana,1,Irecê,26862,12,0,16,0,28,12,16,28,0,104.2364678728,44.6727719455,59.5636959273,104.2364678728,0
2906303,Canavieiras,5,Litoral Sul,33002,17,3,20,1,41,20,21,37,4,124.2348948549,60.6023877341,63.6325071208,112.114417308,12.1204775468
2906402,Candeal,4,Sisal,8837,7,0,8,0,15,7,8,15,0,169.7408622836,79.212402399,90.5284598846,169.7408622836,0
2906501,Candeias,26,Metropolitano de Salvador,89707,88,35,76,19,218,123,95,164,54,243.0133657351,137.1130458047,105.9003199304,182.8173944062,60.1959713289
2906600,Candiba,13,Sertão Produtivo,14792,3,0,5,0,8,3,5,8,0,54.0832882639,20.281233099,33.802055165,54.0832882639,0
2906709,Cândido Sales,20,Sudoeste Baiano,26674,8,0,21,0,29,8,21,29,0,108.720101972,29.9917522681,78.7283497038,108.720101972,0
2906808,Cansanção,4,Sisal,36191,17,1,21,0,39,18,21,38,1,107.7615981874,49.7361222403,58.0254759471,104.9984802852,2.7631179022
2906824,Canudos,10,Sertão do São Francisco,17316,8,0,12,0,20,8,12,20,0,115.5001155001,46.2000462,69.3000693001,115.5001155001,0
2906857,Capela do Alto Alegre,15,Bacia do Jacuípe,12199,10,0,12,0,22,10,12,22,0,180.342651037,81.9739322895,98.3687187474,180.342651037,0
2906873,Capim Grosso,15,Bacia do Jacuípe,31392,18,3,30,0,51,21,30,48,3,162.4617737003,66.8960244648,95.5657492355,152.9051987768,9.5565749235
2906899,Caraíbas,20,Sudoeste Baiano,9773,3,0,12,0,15,3,12,15,0,153.4840888161,30.6968177632,122.7872710529,153.4840888161,0
2906907,Caravelas,7,Extremo Sul,22740,11,0,20,0,31,11,20,31,0,136.3236587511,48.3729111697,87.9507475814,136.3236587511,0
2907004,Cardeal da Silva,18,Litoral Norte e Agreste Baiano,9544,6,0,4,0,10,6,4,10,0,104.7778709137,62.8667225482,41.9111483655,104.7778709137,0
2907103,Carinhanha,2,Velho Chico,30118,15,3,17,0,35,18,17,32,3,116.209575669,59.7649246298,56.4446510392,106.2487548974,9.9608207716
2907202,Casa Nova,10,Sertão do São Francisco,73382,35,1,27,0,63,36,27,62,1,85.8521163228,49.0583521845,36.7937641383,84.4893843177,1.3627320051
2907301,Castro Alves,21,Recôncavo,27238,16,2,29,0,47,18,29,45,2,172.5530508848,66.0841471474,106.4689037374,165.2103678684,7.3426830164
2907400,Catolândia,11,Bacia do Rio Grande,3669,1,0,4,0,5,1,4,5,0,136.2769146907,27.2553829381,109.0215317525,136.2769146907,0
2907509,Catu,18,Litoral Norte e Agreste Baiano,56459,26,27,34,11,98,53,45,60,38,173.5772861723,93.8734302768,79.7038558954,106.2718078606,67.3054783117
2907558,Caturama,12,Bacia do Paramirim,9764,4,0,12,0,16,4,12,16,0,163.8672675133,40.9668168783,122.900450635,163.8672675133,0
2907608,Central,1,Irecê,17969,7,0,12,0,19,7,12,19,0,105.7376593021,38.9559797429,66.7816795592,105.7376593021,0
2907707,Chorrochó,24,Itaparica,11591,5,0,15,0,20,5,15,20,0,172.5476662928,43.1369165732,129.4107497196,172.5476662928,0
2907806,Cícero Dantas,17,Semiárido Nordeste II,34676,13,5,24,0,42,18,24,37,5,121.1212365901,51.9091013958,69.2121351944,106.702041758,14.4191948322
2907905,Cipó,17,Semiárido Nordeste II,17739,8,0,15,0,23,8,15,23,0,129.6578161114,45.0983708214,84.55944529,129.6578161114,0
2908002,Coaraci,5,Litoral Sul,19022,12,2,23,0,37,14,23,35,2,194.5116181264,73.5989906424,120.912627484,183.997476606,10.5141415203
2908101,Cocos,23,Bacia do Rio Corrente,19498,12,0,14,0,26,12,14,26,0,133.3470099497,61.544773823,71.8022361268,133.3470099497,0
2908200,Conceição da Feira,19,Portal do Sertão,23024,14,1,18,1,34,15,19,32,2,147.6719944406,65.149409312,82.5225851286,138.9854065323,8.6865879083
2908309,Conceição do Almeida,21,Recôncavo,18229,15,0,17,0,32,15,17,32,0,175.5444621208,82.2864666191,93.2579955017,175.5444621208,0
2908408,Conceição do Coité,4,Sisal,68303,33,26,46,5,110,59,51,79,31,161.0470989561,86.3798076219,74.6672913342,115.6610983412,45.3860006149
2908507,Conceição do Jacuípe,19,Portal do Sertão,33876,39,12,28,1,80,51,29,67,13,236.1553902468,150.5490612823,85.6063289645,197.7801393317,38.3752509151
2908606,Conde,18,Litoral Norte e Agreste Baiano,26371,14,0,16,0,30,14,16,30,0,113.7613287323,53.0886200751,60.6727086572,113.7613287323,0
2908705,Condeúba,20,Sudoeste Baiano,18191,10,3,26,0,39,13,26,36,3,214.3917321753,71.4639107251,142.9278214502,197.9000604695,16.4916717058
2908804,Contendas do Sincorá,13,Sertão Produtivo,4299,3,0,4,0,7,3,4,7,0,162.8285647825,69.7836706211,93.0448941614,162.8285647825,0
2908903,Coração de Maria,19,Portal do Sertão,23896,13,0,20,0,33,13,20,33,0,138.0984265149,54.4024104453,83.6960160696,138.0984265149,0
2909000,Cordeiros,20,Sudoeste Baiano,8904,8,0,11,0,19,8,11,19,0,213.3872416891,89.8472596586,123.5399820305,213.3872416891,0
2909109,Coribe,23,Bacia do Rio Corrente,14933,13,0,21,0,34,13,21,34,0,227.683653653,87.055514632,140.628139021,227.683653653,0
2909208,Coronel João Sá,17,Semiárido Nordeste II,16814,8,0,10,0,18,8,10,18,0,107.0536457714,47.5793981206,59.4742476508,107.0536457714,0
2909307,Correntina,23,Bacia do Rio Corrente,33361,8,0,18,1,27,8,19,26,1,80.9328257546,23.9800965199,56.9527292347,77.9353136896,2.997512065
2909406,Cotegipe,11,Bacia do Rio Grande,14414,4,0,10,0,14,4,10,14,0,97.127792424,27.7507978354,69.3769945886,97.127792424,0
2909505,Cravolândia,9,Vale do Jiquiriçá,5576,3,0,5,0,8,3,5,8,0,143.4720229555,53.8020086083,89.6700143472,143.4720229555,0
2909604,Crisópolis,18,Litoral Norte e Agreste Baiano,21835,14,0,18,0,32,14,18,32,0,146.553698191,64.1172429586,82.4364552324,146.553698191,0
2909703,Cristópolis,11,Bacia do Rio Grande,14403,6,0,14,0,20,6,14,20,0,138.8599597306,41.6579879192,97.2019718114,138.8599597306,0
2909802,Cruz das Almas,21,Recôncavo,64932,55,42,54,5,156,97,59,109,47,240.2513398632,149.3870510688,90.8642887944,167.867923366,72.3834164973
2909901,Curaçá,10,Sertão do São Francisco,35524,15,0,22,0,37,15,22,37,0,104.154937507,42.224974665,61.929962842,104.154937507,0
2910008,Dário Meira,22,Médio Rio de Contas,11716,0,0,10,0,10,0,10,10,0,85.3533629225,0,85.3533629225,85.3533629225,0
2910057,Dias D'Ávila,26,Metropolitano de Salvador,80657,38,23,53,4,118,61,57,91,27,146.2985233768,75.6288976778,70.6696256989,112.8234375194,33.4750858574
2910107,Dom Basílio,13,Sertão Produtivo,12604,8,0,10,0,18,8,10,18,0,142.8118057759,63.4719136782,79.3398920977,142.8118057759,0
2910206,Dom Macedo Costa,21,Recôncavo,4212,3,0,5,0,8,3,5,8,0,189.9335232669,71.2250712251,118.7084520418,189.9335232669,0
2910305,Elísio Medrado,9,Vale do Jiquiriçá,8461,2,0,8,0,10,2,8,10,0,118.1893393216,23.6378678643,94.5514714573,118.1893393216,0
2910404,Encruzilhada,20,Sudoeste Baiano,19376,12,0,14,0,26,12,14,26,0,134.1866226259,61.9322873658,72.2543352601,134.1866226259,0
2910503,Entre Rios,18,Litoral Norte e Agreste Baiano,43223,22,4,28,0,54,26,28,50,4,124.9334844874,60.1531591976,64.7803252898,115.6791523032,9.2543321843
2910602,Esplanada,18,Litoral Norte e Agreste Baiano,37845,11,2,26,0,39,13,26,37,2,103.0519223147,34.3506407716,68.7012815431,97.7672083498,5.2847139649
2910701,Euclides da Cunha,17,Semiárido Nordeste II,61924,34,4,53,1,92,38,54,87,5,148.5692138751,61.3655448614,87.2036690136,140.4948000775,8.0744137976
2910727,Eunápolis,27,Costa do Descobrimento,115290,131,47,137,10,325,178,147,268,57,281.8978228814,154.3932691474,127.5045537341,232.4572816376,49.4405412438
2910750,Fátima,17,Semiárido Nordeste II,18443,6,1,19,0,26,7,19,25,1,140.9748956244,37.9547795912,103.0201160332,135.5527842542,5.4221113702
2910776,Feira da Mata,2,Velho Chico,5922,3,0,5,0,8,3,5,8,0,135.0894967916,50.6585612969,84.4309354948,135.0894967916,0
2910800,Feira de Santana,19,Portal do Sertão,627477,890,133,865,36,1924,1023,901,1755,169,306.6247846535,163.0338641894,143.590920464,279.691526542,26.9332581115
2910859,Filadélfia,25,Piemonte Norte do Itapicuru,17176,12,0,14,0,26,12,14,26,0,151.3740102469,69.8649278062,81.5090824406,151.3740102469,0
2910909,Firmino Alves,8,Médio Sudoeste da Bahia,5822,2,0,2,0,4,2,2,4,0,68.7049124012,34.3524562006,34.3524562006,68.7049124012,0
2911006,Floresta Azul,5,Litoral Sul,11244,4,0,9,0,13,4,9,13,0,115.6172180719,35.5745286375,80.0426894344,115.6172180719,0
2911105,Formosa do Rio Preto,11,Bacia do Rio Grande,25912,4,0,18,0,22,4,18,22,0,84.9027477617,15.4368632294,69.4658845323,84.9027477617,0
2911204,Gandu,6,Baixo Sul,33234,15,20,24,1,60,35,25,39,21,180.5380032497,105.313835229,75.2241680207,117.3497021123,63.1883011374
2911253,Gavião,15,Bacia do Jacuípe,4725,1,0,5,0,6,1,5,6,0,126.9841269841,21.164021164,105.8201058201,126.9841269841,0
2911303,Gentio do Ouro,1,Irecê,11639,4,0,7,0,11,4,7,11,0,94.5098376149,34.3672136782,60.1426239368,94.5098376149,0
2911402,Glória,24,Itaparica,15840,8,0,6,0,14,8,6,14,0,88.3838383838,50.5050505051,37.8787878788,88.3838383838,0
2911501,Gongogi,22,Médio Rio de Contas,7848,6,0,7,0,13,6,7,13,0,165.6472986748,76.4525993884,89.1946992864,165.6472986748,0
2911600,Governador Mangabeira,21,Recôncavo,21495,12,1,14,2,29,13,16,26,3,134.9150965341,60.4791812049,74.4359153291,120.9583624099,13.9567341242
2911659,Guajeru,20,Sudoeste Baiano,8081,7,0,8,0,15,7,8,15,0,185.620591511,86.6229427051,98.9976488058,185.620591511,0
2911709,Guanambi,13,Sertão Produtivo,86808,155,22,174,3,354,177,177,329,25,407.7965164501,203.898258225,203.898258225,378.9973274353,28.7991890148
2911808,Guaratinga,27,Costa do Descobrimento,22154,6,0,20,0,26,6,20,26,0,117.3602961091,27.0831452559,90.2771508531,117.3602961091,0
2911857,Heliópolis,17,Semiárido Nordeste II,13718,4,0,6,0,10,4,6,10,0,72.8969237498,29.1587694999,43.7381542499,72.8969237498,0
2911907,Iaçu,14,Piemonte do Paraguaçu,25884,16,2,16,0,34,18,16,32,2,131.3552773914,69.5410292072,61.8142481842,123.6284963684,7.726781023
2912004,Ibiassucê,13,Sertão Produtivo,10183,4,0,13,0,17,4,13,17,0,166.9449081803,39.281154866,127.6637533143,166.9449081803,0
2912103,Ibicaraí,5,Litoral Sul,23529,12,0,26,0,38,12,26,38,0,161.5028262995,51.0008925156,110.5019337838,161.5028262995,0
2912202,Ibicoara,3,Chapada Diamantina,19786,6,1,14,0,21,7,14,20,1,106.1356514707,35.3785504902,70.7571009805,101.0815728293,5.0540786415
2912301,Ibicuí,8,Médio Sudoeste da Bahia,16796,6,3,19,0,28,9,19,25,3,166.7063586568,53.5841867111,113.1221719457,148.8449630865,17.8613955704
2912400,Ibipeba,1,Irecê,18678,4,1,13,2,20,5,15,17,3,107.0778455937,26.7694613984,80.3083841953,91.0161687547,16.0616768391
2912509,Ibipitanga,12,Bacia do Paramirim,15413,4,1,12,0,17,5,12,16,1,110.2965029521,32.4401479271,77.856355025,103.8084733666,6.4880295854
2912608,Ibiquera,14,Piemonte do Paraguaçu,4214,1,0,4,0,5,1,4,5,0,118.6521120076,23.7304224015,94.9216896061,118.6521120076,0
2912707,Ibirapitanga,6,Baixo Sul,24293,9,0,13,0,22,9,13,22,0,90.561066974,37.0477092166,53.5133577574,90.561066974,0
2912806,Ibirapoã,7,Extremo Sul,8852,6,0,6,0,12,6,6,12,0,135.5625847266,67.7812923633,67.7812923633,135.5625847266,0
2912905,Ibirataia,22,Médio Rio de Contas,17221,9,0,13,0,22,9,13,22,0,127.751001684,52.2617734162,75.4892282678,127.751001684,0
2913002,Ibitiara,3,Chapada Diamantina,16855,6,0,9,0,15,6,9,15,0,88.9943636903,35.5977454761,53.3966182142,88.9943636903,0
2913101,Ibititá,1,Irecê,17948,6,1,10,0,17,7,10,16,1,94.7180744373,39.0015600624,55.7165143749,89.1464229998,5.5716514375
2913200,Ibotirama,2,Velho Chico,27862,15,6,38,0,59,21,38,53,6,211.7579498959,75.3714736918,136.3864762041,190.2232431268,21.5347067691
2913309,Ichu,4,Sisal,6437,5,0,6,0,11,5,6,11,0,170.8870591891,77.675935995,93.211123194,170.8870591891,0
2913408,Igaporã,2,Velho Chico,16283,4,0,16,0,20,4,16,20,0,122.827488792,24.5654977584,98.2619910336,122.827488792,0
2913457,Igrapiúna,6,Baixo Sul,14187,8,0,15,0,23,8,15,23,0,162.120250934,56.3896524988,105.7305984352,162.120250934,0
2913507,Iguaí,8,Médio Sudoeste da Bahia,27939,10,0,13,0,23,10,13,23,0,82.3222019399,35.792261713,46.5299402269,82.3222019399,0
2913606,Ilhéus,5,Litoral Sul,176341,198,71,229,13,511,269,242,427,84,289.7794613845,152.5453524705,137.234108914,242.1444814309,47.6349799536
2913705,Inhambupe,18,Litoral Norte e Agreste Baiano,40453,18,0,26,0,44,18,26,44,0,108.7682001335,44.4960818728,64.2721182607,108.7682001335,0
2913804,Ipecaetá,19,Portal do Sertão,15499,5,0,10,0,15,5,10,15,0,96.7804374476,32.2601458159,64.5202916317,96.7804374476,0
2913903,Ipiaú,22,Médio Rio de Contas,47704,47,12,56,3,118,59,59,103,15,247.3587120577,123.6793560288,123.6793560288,215.9148079826,31.4439040751
2914000,Ipirá,15,Bacia do Jacuípe,62631,17,5,31,2,55,22,33,48,7,87.8159377944,35.1263751178,52.6895626766,76.6393638933,11.1765739011
2914109,Ipupiara,1,Irecê,10157,3,0,10,0,13,3,10,13,0,127.9905483903,29.5362803978,98.4542679925,127.9905483903,0
2914208,Irajuba,9,Vale do Jiquiriçá,7521,1,0,7,0,8,1,7,8,0,106.3688339317,13.2961042415,93.0727296902,106.3688339317,0
2914307,Iramaia,3,Chapada Diamantina,9901,6,0,8,0,14,6,8,14,0,141.3998586001,60.5999394001,80.7999192001,141.3998586001,0
2914406,Iraquara,3,Chapada Diamantina,25536,13,1,6,0,20,14,6,19,1,78.320802005,54.8245614035,23.4962406015,74.4047619048,3.9160401003
2914505,Irará,19,Portal do Sertão,29879,7,4,18,0,29,11,18,25,4,97.0581344757,36.8151544563,60.2429800194,83.6708055825,13.3873288932
2914604,Irecê,1,Irecê,74483,141,10,117,2,270,151,119,258,12,362.4988252353,202.7308244834,159.7680007519,346.3877663359,16.1110588993
2914653,Itabela,27,Costa do Descobrimento,31422,11,3,29,0,43,14,29,40,3,136.846795239,44.5547705429,92.2920246961,127.2993444084,9.5474508306
2914703,Itaberaba,14,Piemonte do Paraguaçu,66806,29,14,50,3,96,43,53,79,17,143.6996676945,64.3654761548,79.3341915397,118.2528515403,25.4468161542
2914802,Itabuna,5,Litoral Sul,221046,364,46,353,26,789,410,379,717,72,356.939279607,185.4817549288,171.4575246781,324.3668738634,32.5724057436
2914901,Itacaré,5,Litoral Sul,28382,18,3,19,0,40,21,19,37,3,140.9343950391,73.9905573955,66.9438376436,130.3643154112,10.5700796279
2915007,Itaetê,3,Chapada Diamantina,16586,2,0,13,0,15,2,13,15,0,90.4377185578,12.0583624744,78.3793560834,90.4377185578,0
2915106,Itagi,22,Médio Rio de Contas,13199,3,0,12,0,15,3,12,15,0,113.644973104,22.7289946208,90.9159784832,113.644973104,0
2915205,Itagibá,22,Médio Rio de Contas,15577,6,0,12,0,18,6,12,18,0,115.5549849137,38.5183283046,77.0366566091,115.5549849137,0
2915304,Itagimirim,27,Costa do Descobrimento,7291,3,0,4,0,7,3,4,7,0,96.0087779454,41.1466191195,54.8621588259,96.0087779454,0
2915353,Itaguaçu da Bahia,1,Irecê,14718,6,0,10,0,16,6,10,16,0,108.7104226118,40.7664084794,67.9440141324,108.7104226118,0
2915403,Itaju do Colônia,5,Litoral Sul,7218,3,0,7,0,10,3,7,10,0,138.5425325575,41.5627597672,96.9797727902,138.5425325575,0
2915502,Itajuípe,5,Litoral Sul,21642,4,0,18,0,22,4,18,22,0,101.6541909251,18.4825801682,83.1716107569,101.6541909251,0
2915601,Itamaraju,7,Extremo Sul,67356,39,8,64,4,115,47,68,103,12,170.7346041926,69.7784904092,100.9561137835,152.9188194073,17.8157847853
2915700,Itamari,22,Médio Rio de Contas,8476,1,0,5,0,6,1,5,6,0,70.7881075979,11.798017933,58.9900896649,70.7881075979,0
2915809,Itambé,8,Médio Sudoeste da Bahia,24901,13,0,21,0,34,13,21,34,0,136.5407011767,52.2067386852,84.3339624915,136.5407011767,0
2915908,Itanagra,18,Litoral Norte e Agreste Baiano,6730,4,0,7,0,11,4,7,11,0,163.4472511144,59.4353640416,104.0118870728,163.4472511144,0
2916005,Itanhém,7,Extremo Sul,20501,10,2,16,0,28,12,16,26,2,136.5787034779,58.5337300619,78.0449734159,126.8230818009,9.755621677
2916104,Itaparica,26,Metropolitano de Salvador,22866,24,3,23,0,50,27,23,47,3,218.665267209,118.0792442928,100.5860229161,205.5453511764,13.1199160325
2916203,Itapé,5,Litoral Sul,9830,2,0,13,0,15,2,13,15,0,152.5940996948,20.3458799593,132.2482197355,152.5940996948,0
2916302,Itapebi,27,Costa do Descobrimento,10830,4,0,12,0,16,4,12,16,0,147.7377654663,36.9344413666,110.8033240997,147.7377654663,0
2916401,Itapetinga,8,Médio Sudoeste da Bahia,77533,52,21,74,1,148,73,75,126,22,190.8864612488,94.1534572376,96.7330040112,162.5114467388,28.37501451
2916500,Itapicuru,18,Litoral Norte e Agreste Baiano,36211,21,0,27,0,48,21,27,48,0,132.5564055121,57.9934274116,74.5629781006,132.5564055121,0
2916609,Itapitanga,5,Litoral Sul,10799,3,0,9,0,12,3,9,12,0,111.1214001296,27.7803500324,83.3410500972,111.1214001296,0
2916708,Itaquara,9,Vale do Jiquiriçá,8592,3,0,9,0,12,3,9,12,0,139.6648044693,34.9162011173,104.748603352,139.6648044693,0
2916807,Itarantim,8,Médio Sudoeste da Bahia,20314,7,1,15,1,24,8,16,22,2,118.145121591,39.381707197,78.763414394,108.2996947918,9.8454267993
2916856,Itatim,14,Piemonte do Paraguaçu,14957,10,0,16,0,26,10,16,26,0,173.8316507321,66.8583272047,106.9733235274,173.8316507321,0
2916906,Itiruçu,9,Vale do Jiquiriçá,13254,2,0,9,0,11,2,9,11,0,82.9938131885,15.0897842161,67.9040289724,82.9938131885,0
2917003,Itiúba,4,Sisal,37567,10,1,9,0,20,11,9,19,1,53.2382143903,29.2810179147,23.9571964756,50.5763036708,2.6619107195
2917102,Itororó,8,Médio Sudoeste da Bahia,21241,8,1,13,0,22,9,13,21,1,103.5732780943,42.3708864931,61.2023916011,98.8654018172,4.707876277
2917201,Ituaçu,13,Sertão Produtivo,19577,9,1,19,0,29,10,19,28,1,148.1330132298,51.0803493896,97.0526638402,143.0249782909,5.108034939
2917300,Ituberá,6,Baixo Sul,29428,5,3,13,2,23,8,15,18,5,78.1568574147,27.1849938834,50.9718635313,61.1662362376,16.9906211771
2917334,Iuiu,13,Sertão Produtivo,11399,5,0,8,0,13,5,8,13,0,114.0450916747,43.863496798,70.1815948767,114.0450916747,0
2917359,Jaborandi,23,Bacia do Rio Corrente,9056,3,0,11,0,14,3,11,14,0,154.593639576,33.1272084806,121.4664310954,154.593639576,0
2917409,Jacaraci,20,Sudoeste Baiano,15459,5,0,16,0,21,5,16,21,0,135.843198137,32.343618604,103.499579533,135.843198137,0
2917508,Jacobina,16,Piemonte da Diamantina,83635,50,39,70,6,165,89,76,120,45,197.2858253124,106.4147785018,90.8710468105,143.4806002272,53.8052250852
2917607,Jaguaquara,9,Vale do Jiquiriçá,56033,19,8,48,1,76,27,49,67,9,135.6343583246,48.1858904574,87.4484678671,119.5723948388,16.0619634858
2917706,Jaguarari,25,Piemonte Norte do Itapicuru,34499,15,1,9,3,28,16,12,24,4,81.161772805,46.3781558886,34.7836169164,69.5672338329,11.5945389721
2917805,Jaguaripe,6,Baixo Sul,19036,6,0,9,0,15,6,9,15,0,78.7980668208,31.5192267283,47.2788400925,78.7980668208,0
2917904,Jandaíra,18,Litoral Norte e Agreste Baiano,11120,3,0,3,0,6,3,3,6,0,53.9568345324,26.9784172662,26.9784172662,53.9568345324,0
2918001,Jequié,22,Médio Rio de Contas,162209,180,52,308,13,553,232,321,488,65,340.9181981271,143.0253561763,197.8928419508,300.8464388536,40.0717592735
2918100,Jeremoabo,17,Semiárido Nordeste II,41605,14,1,44,1,60,15,45,58,2,144.2134358851,36.0533589713,108.1600769138,139.4063213556,4.8071145295
2918209,Jiquiriçá,9,Vale do Jiquiriçá,15106,9,0,12,0,21,9,12,21,0,139.0176088971,59.5789752416,79.4386336555,139.0176088971,0
2918308,Jitaúna,22,Médio Rio de Contas,12692,1,0,14,0,15,1,14,15,0,118.184683265,7.8789788843,110.3057043807,118.184683265,0
2918357,João Dourado,1,Irecê,25646,3,0,10,0,13,3,10,13,0,50.6901661078,11.6977306403,38.9924354675,50.6901661078,0
2918407,Juazeiro,10,Sertão do São Francisco,221773,339,142,293,2,776,481,295,632,144,349.9073376831,216.8884399814,133.0188977017,284.976079144,64.9312585391
2918456,Jucuruçu,7,Extremo Sul,9924,4,0,9,0,13,4,9,13,0,130.9955663039,40.3063280935,90.6892382104,130.9955663039,0
2918506,Jussara,1,Irecê,16006,4,0,12,0,16,4,12,16,0,99.9625140572,24.9906285143,74.9718855429,99.9625140572,0
2918555,Jussari,5,Litoral Sul,6275,4,0,8,0,12,4,8,12,0,191.235059761,63.7450199203,127.4900398406,191.235059761,0
2918605,Jussiape,3,Chapada Diamantina,7066,6,0,10,0,16,6,10,16,0,226.4364562695,84.913671101,141.5227851684,226.4364562695,0
2918704,Lafayette Coutinho,9,Vale do Jiquiriçá,3975,1,0,7,0,8,1,7,8,0,201.2578616352,25.1572327044,176.1006289308,201.2578616352,0
2918753,Lagoa Real,13,Sertão Produtivo,16029,2,0,10,0,12,2,10,12,0,74.864308441,12.4773847402,62.3869237008,74.864308441,0
2918803,Laje,9,Vale do Jiquiriçá,24306,13,1,22,0,36,14,22,35,1,148.1115773883,57.5989467621,90.5126306262,143.9973669053,4.114210483
2918902,Lajedão,7,Extremo Sul,4068,2,0,12,0,14,2,12,14,0,344.1494591937,49.1642084562,294.9852507375,344.1494591937,0
2919009,Lajedinho,14,Piemonte do Paraguaçu,4017,0,0,-,0,0,0,#VALOR!,#VALOR!,0,0,0,#VALOR!,#VALOR!,0
2919058,Lajedo do Tabocal,9,Vale do Jiquiriçá,8886,1,0,10,0,11,1,10,11,0,123.7902318253,11.2536574387,112.5365743867,123.7902318253,0
2919108,Lamarão,4,Sisal,9007,0,0,8,0,8,0,8,8,0,88.8198068169,0,88.8198068169,88.8198068169,0
2919157,Lapão,1,Irecê,28244,6,0,18,0,24,6,18,24,0,84.9737997451,21.2434499363,63.7303498088,84.9737997451,0
2919207,Lauro de Freitas,26,Metropolitano de Salvador,197636,235,238,178,20,671,473,198,413,258,339.5130441822,239.3288672104,100.1841769718,208.9700257038,130.5430184784
2919306,Lençóis,3,Chapada Diamantina,11636,4,0,15,0,19,4,15,19,0,163.2863526985,34.3760742523,128.9102784462,163.2863526985,0
2919405,Licínio de Almeida,20,Sudoeste Baiano,12969,3,0,11,0,14,3,11,14,0,107.9497262703,23.1320842008,84.8176420696,107.9497262703,0
2919504,Livramento de Nossa Senhora,13,Sertão Produtivo,46739,13,8,50,5,76,21,55,63,13,162.6051049445,44.9303579452,117.6747469993,134.7910738356,27.8140311089
2919553,Luís Eduardo Magalhães,11,Bacia do Rio Grande,83557,48,16,59,2,125,64,61,107,18,149.5984776859,76.5944205752,73.0040571107,128.0562968991,21.5421807868
2919603,Macajuba,14,Piemonte do Paraguaçu,11879,5,0,6,0,11,5,6,11,0,92.600387238,42.0910851082,50.5093021298,92.600387238,0
2919702,Macarani,8,Médio Sudoeste da Bahia,19110,7,0,17,0,24,7,17,24,0,125.5886970173,36.63003663,88.9586603872,125.5886970173,0
2919801,Macaúbas,12,Bacia do Paramirim,50987,22,0,46,0,68,22,46,68,0,133.367328927,43.1482534764,90.2190754506,133.367328927,0
2919900,Macururé,24,Itaparica,8266,3,0,8,0,11,3,8,11,0,133.0752480039,36.2932494556,96.7819985483,133.0752480039,0
2919926,Madre de Deus,26,Metropolitano de Salvador,21007,18,1,22,1,42,19,23,40,2,199.9333555482,90.4460417956,109.4873137526,190.4127195697,9.5206359785
2919959,Maetinga,20,Sudoeste Baiano,4456,9,0,12,0,21,9,12,21,0,471.2746858169,201.9748653501,269.2998204668,471.2746858169,0
2920007,Maiquinique,8,Médio Sudoeste da Bahia,10274,3,0,7,0,10,3,7,10,0,97.3330737785,29.1999221335,68.1331516449,97.3330737785,0
2920106,Mairi,15,Bacia do Jacuípe,19695,12,1,28,0,41,13,28,40,1,208.1746636202,66.0066006601,142.1680629601,203.0972328002,5.07743082
2920205,Malhada,2,Velho Chico,17526,1,0,10,0,11,1,10,11,0,62.7638936437,5.7058085131,57.0580851307,62.7638936437,0
2920304,Malhada de Pedras,13,Sertão Produtivo,8856,2,0,6,0,8,2,6,8,0,90.3342366757,22.5835591689,67.7506775068,90.3342366757,0
2920403,Manoel Vitorino,22,Médio Rio de Contas,14251,1,0,16,0,17,1,16,17,0,119.2898743948,7.017051435,112.2728229598,119.2898743948,0
2920452,Mansidão,11,Bacia do Rio Grande,13959,5,0,6,0,11,5,6,11,0,78.8022064618,35.8191847554,42.9830217064,78.8022064618,0
2920502,Maracás,9,Vale do Jiquiriçá,23018,6,1,24,0,31,7,24,30,1,134.6772091407,30.4109827092,104.2662264315,130.3327830394,4.3444261013
2920601,Maragogipe,21,Recôncavo,46260,13,0,22,0,35,13,22,35,0,75.6593169045,28.1020319931,47.5572849114,75.6593169045,0
2920700,Maraú,5,Litoral Sul,21313,5,0,15,0,20,5,15,20,0,93.8394407169,23.4598601792,70.3795805377,93.8394407169,0
2920809,Marcionílio Souza,3,Chapada Diamantina,10931,3,0,3,0,6,3,3,6,0,54.8897630592,27.4448815296,27.4448815296,54.8897630592,0
2920908,Mascote,5,Litoral Sul,14728,3,0,14,0,17,3,14,17,0,115.4263986964,20.3693644758,95.0570342205,115.4263986964,0
2921005,Mata de São João,26,Metropolitano de Salvador,46998,28,3,31,1,63,31,32,59,4,134.0482573727,65.9602536278,68.0880037448,125.5372569046,8.5110004681
2921054,Matina,2,Velho Chico,12488,3,0,10,0,13,3,10,13,0,104.0999359385,24.0230621397,80.0768737988,104.0999359385,0
2921104,Medeiros Neto,7,Extremo Sul,23586,17,0,20,0,37,17,20,37,0,156.8727211057,72.0766556432,84.7960654626,156.8727211057,0
2921203,Miguel Calmon,16,Piemonte da Diamantina,27520,11,2,28,1,42,13,29,39,3,152.6162790698,47.238372093,105.3779069767,141.7151162791,10.9011627907
2921302,Milagres,9,Vale do Jiquiriçá,11585,3,0,10,0,13,3,10,13,0,112.214069918,25.8955545965,86.3185153215,112.214069918,0
2921401,Mirangaba,16,Piemonte da Diamantina,18729,6,0,9,0,15,6,9,15,0,80.0897004645,32.0358801858,48.0538202787,80.0897004645,0
2921450,Mirante,20,Sudoeste Baiano,9578,4,1,7,0,12,5,7,11,1,125.2871163082,52.2029651284,73.0841511798,114.8465232825,10.4405930257
2921500,Monte Santo,4,Sisal,51953,12,0,20,0,32,12,20,32,0,61.5941331588,23.0977999346,38.4963332243,61.5941331588,0
2921609,Morpará,2,Velho Chico,8950,5,0,11,0,16,5,11,16,0,178.7709497207,55.8659217877,122.905027933,178.7709497207,0
2921708,Morro do Chapéu,3,Chapada Diamantina,36856,23,0,34,0,57,23,34,57,0,154.6559583243,62.4050358151,92.2509225092,154.6559583243,0
2921807,Mortugaba,20,Sudoeste Baiano,12529,7,1,14,1,23,8,15,21,2,183.5741080693,63.8518636763,119.722244393,167.6111421502,15.9629659191
2921906,Mucugê,3,Chapada Diamantina,9957,5,0,13,0,18,5,13,18,0,180.7773425731,50.2159284925,130.5614140805,180.7773425731,0
2922003,Mucuri,7,Extremo Sul,42072,41,7,34,0,82,48,34,75,7,194.9039741396,114.0901312037,80.8138429359,178.2658300057,16.6381441339
2922052,Mulungu do Morro,1,Irecê,11988,4,0,8,0,12,4,8,12,0,100.1001001001,33.3667000334,66.7334000667,100.1001001001,0
2922102,Mundo Novo,14,Piemonte do Paraguaçu,27364,6,0,9,0,15,6,9,15,0,54.8165472884,21.9266189154,32.889928373,54.8165472884,0
2922201,Muniz Ferreira,21,Recôncavo,7678,4,0,6,0,10,4,6,10,0,130.2422505861,52.0969002344,78.1453503517,130.2422505861,0
2922250,Muquém do São Francisco,2,Velho Chico,11644,1,0,8,0,9,1,8,9,0,77.2930264514,8.5881140502,68.7049124012,77.2930264514,0
2922300,Muritiba,21,Recôncavo,30631,10,3,29,0,42,13,29,39,3,137.1159936013,42.4406646861,94.6753289152,127.3219940583,9.7939995429
2922409,Mutuípe,9,Vale do Jiquiriçá,22998,8,6,17,0,31,14,17,25,6,134.7943299417,60.8748586834,73.9194712584,108.7051047917,26.08922515
2922508,Nazaré,21,Recôncavo,29546,18,3,34,1,56,21,35,52,4,189.5349624315,71.0756109118,118.4593515197,175.9967508292,13.5382116022
2922607,Nilo Peçanha,6,Baixo Sul,14368,4,0,10,0,14,4,10,14,0,97.438752784,27.8396436526,69.5991091314,97.438752784,0
2922656,Nordestina,4,Sisal,13597,6,0,11,0,17,6,11,17,0,125.0275796132,44.1273810399,80.9001985732,125.0275796132,0
2922706,Nova Canaã,8,Médio Sudoeste da Bahia,17141,6,0,14,0,20,6,14,20,0,116.6793069249,35.0037920775,81.6755148474,116.6793069249,0
2922730,Nova Fátima,15,Bacia do Jacuípe,8119,1,2,12,1,16,3,13,13,3,197.0686045079,36.9503633452,160.1182411627,160.1182411627,36.9503633452
2922755,Nova Ibiá,22,Médio Rio de Contas,6986,1,0,8,0,9,1,8,9,0,128.8290867449,14.3143429717,114.5147437733,128.8290867449,0
2922805,Nova Itarana,9,Vale do Jiquiriçá,8428,3,0,3,0,6,3,3,6,0,71.1912672046,35.5956336023,35.5956336023,71.1912672046,0
2922854,Nova Redenção,3,Chapada Diamantina,9500,4,0,5,0,9,4,5,9,0,94.7368421053,42.1052631579,52.6315789474,94.7368421053,0
2922904,Nova Soure,17,Semiárido Nordeste II,25460,8,1,20,0,29,9,20,28,1,113.9041633936,35.3495679497,78.5545954438,109.9764336214,3.9277297722
2923001,Nova Viçosa,7,Extremo Sul,44052,21,1,27,0,49,22,27,48,1,111.2321801507,49.9409788432,61.2912013075,108.9621356579,2.2700444929
2923035,Novo Horizonte,3,Chapada Diamantina,12514,4,0,7,0,11,4,7,11,0,87.9015502637,31.9642000959,55.9373501678,87.9015502637,0
2923050,Novo Triunfo,17,Semiárido Nordeste II,16037,4,0,6,0,10,4,6,10,0,62.3558022074,24.942320883,37.4134813244,62.3558022074,0
2923100,Olindina,18,Litoral Norte e Agreste Baiano,29227,7,1,14,0,22,8,14,21,1,75.2728641325,27.3719505936,47.9009135389,71.8513703083,3.4214938242
2923209,Oliveira dos Brejinhos,2,Velho Chico,22805,7,0,12,0,19,7,12,19,0,83.3150624863,30.6950230213,52.620039465,83.3150624863,0
2923308,Ouriçangas,18,Litoral Norte e Agreste Baiano,8916,4,0,5,0,9,4,5,9,0,100.9421265141,44.8631673396,56.0789591745,100.9421265141,0
2923357,Ourolândia,16,Piemonte da Diamantina,18025,5,2,10,1,18,7,11,15,3,99.8613037448,38.8349514563,61.0263522885,83.2177531207,16.6435506241
2923407,Palmas de Monte Alto,13,Sertão Produtivo,22553,7,0,11,0,18,7,11,18,0,79.8119984038,31.0379993792,48.7739990245,79.8119984038,0
2923506,Palmeiras,3,Chapada Diamantina,9250,5,0,6,1,12,5,7,11,1,129.7297297297,54.0540540541,75.6756756757,118.9189189189,10.8108108108
2923605,Paramirim,12,Bacia do Paramirim,22286,16,6,35,4,61,22,39,51,10,273.7144395585,98.7166831194,174.997756439,228.8432199587,44.8712195997
2923704,Paratinga,2,Velho Chico,32967,5,0,17,0,22,5,17,22,0,66.7334000667,15.1666818333,51.5667182334,66.7334000667,0
2923803,Paripiranga,17,Semiárido Nordeste II,30075,10,3,19,0,32,13,19,29,3,106.4006650042,43.2252701579,63.1753948462,96.42560266,9.9750623441
2923902,Pau-Brasil,5,Litoral Sul,10673,4,0,12,0,16,4,12,16,0,149.9109903495,37.4777475874,112.4332427621,149.9109903495,0
2924009,Paulo Afonso,24,Itaparica,120706,108,50,93,8,259,158,101,201,58,214.570940964,130.8965585804,83.6743823836,166.5203055358,48.0506354282
2924058,Pé de Serra,15,Bacia do Jacuípe,14226,7,1,14,0,22,8,14,21,1,154.6464220441,56.2350625615,98.4113594826,147.617039224,7.0293828202
2924108,Pedrão,18,Litoral Norte e Agreste Baiano,7527,3,0,6,0,9,3,6,9,0,119.5695496214,39.8565165405,79.7130330809,119.5695496214,0
2924207,Pedro Alexandre,17,Semiárido Nordeste II,18209,5,0,13,0,18,5,13,18,0,98.8522159372,27.4589488714,71.3932670657,98.8522159372,0
2924306,Piatã,3,Chapada Diamantina,18267,5,1,14,0,20,6,14,19,1,109.487053156,32.8461159468,76.6409372092,104.0127004982,5.4743526578
2924405,Pilão Arcado,10,Sertão do São Francisco,35740,7,0,12,0,19,7,12,19,0,53.161723559,19.5858981533,33.5758254057,53.161723559,0
2924504,Pindaí,13,Sertão Produtivo,16889,1,0,13,0,14,1,13,14,0,82.8941914856,5.9210136775,76.973177808,82.8941914856,0
2924603,Pindobaçu,25,Piemonte Norte do Itapicuru,21171,3,0,7,0,10,3,7,10,0,47.2344244485,14.1703273346,33.064097114,47.2344244485,0
2924652,Pintadas,15,Bacia do Jacuípe,11012,2,0,7,0,9,2,7,9,0,81.7290228841,18.1620050854,63.5670177988,81.7290228841,0
2924678,Piraí do Norte,6,Baixo Sul,10411,0,0,7,0,7,0,7,7,0,67.2365766977,0,67.2365766977,67.2365766977,0
2924702,Piripá,20,Sudoeste Baiano,11849,3,0,17,0,20,3,17,20,0,168.7906152418,25.3185922863,143.4720229555,168.7906152418,0
2924801,Piritiba,14,Piemonte do Paraguaçu,25211,7,0,13,0,20,7,13,20,0,79.3304509936,27.7656578478,51.5647931458,79.3304509936,0
2924900,Planaltino,9,Vale do Jiquiriçá,9582,1,0,5,0,6,1,5,6,0,62.6174076393,10.4362346066,52.1811730328,62.6174076393,0
2925006,Planalto,20,Sudoeste Baiano,26915,6,0,17,0,23,6,17,23,0,85.4542076909,22.2924020063,63.1618056846,85.4542076909,0
2925105,Poções,20,Sudoeste Baiano,48861,16,8,36,0,60,24,36,52,8,122.7973230184,49.1189292073,73.678393811,106.4243466159,16.3729764024
2925204,Pojuca,26,Metropolitano de Salvador,39718,29,3,40,0,72,32,40,69,3,181.2780099703,80.5680044312,100.7100055391,173.7247595549,7.5532504154
2925253,Ponto Novo,25,Piemonte Norte do Itapicuru,15830,3,0,5,0,8,3,5,8,0,50.5369551485,18.9513581807,31.5855969678,50.5369551485,0
2925303,Porto Seguro,27,Costa do Descobrimento,149324,98,32,167,4,301,130,171,265,36,201.5750984437,87.0590126169,114.5160858268,177.4664487959,24.1086496477
2925402,Potiraguá,8,Médio Sudoeste da Bahia,8438,3,0,9,0,12,3,9,12,0,142.2137947381,35.5534486845,106.6603460536,142.2137947381,0
2925501,Prado,7,Extremo Sul,29326,16,1,29,0,46,17,29,45,1,156.8573961672,57.969037714,98.8883584532,153.4474527723,3.4099433949
2925600,Presidente Dutra,1,Irecê,15734,1,0,16,0,17,1,16,17,0,108.0462692259,6.3556628956,101.6906063302,108.0462692259,0
2925709,Presidente Jânio Quadros,20,Sudoeste Baiano,13334,5,0,14,1,20,5,15,19,1,149.992500375,37.4981250937,112.4943752812,142.4928753562,7.4996250187
2925758,Presidente Tancredo Neves,6,Baixo Sul,28082,11,4,19,1,35,15,20,30,5,124.6349975073,53.4149989317,71.2199985756,106.8299978634,17.8049996439
2925808,Queimadas,4,Sisal,26552,7,1,15,0,23,8,15,22,1,86.6224766496,30.1295570955,56.4929195541,82.8562820127,3.7661946369
2925907,Quijingue,4,Sisal,28632,9,0,15,0,24,9,15,24,0,83.8222967309,31.4333612741,52.3889354568,83.8222967309,0
2925931,Quixabeira,15,Bacia do Jacuípe,9411,1,0,7,0,8,1,7,8,0,85.0069068112,10.6258633514,74.3810434598,85.0069068112,0
2925956,Rafael Jambeiro,14,Piemonte do Paraguaçu,23562,10,0,23,0,33,10,23,33,0,140.056022409,42.4412189118,97.6148034972,140.056022409,0
2926004,Remanso,10,Sertão do São Francisco,42672,21,5,26,3,55,26,29,47,8,128.8901387327,60.9298837645,67.9602549681,110.1424821897,18.7476565429
2926103,Retirolândia,4,Sisal,14730,8,0,14,0,22,8,14,22,0,149.3550577054,54.3109300747,95.0441276307,149.3550577054,0
2926202,Riachão das Neves,11,Bacia do Rio Grande,23313,4,0,16,0,20,4,16,20,0,85.789044739,17.1578089478,68.6312357912,85.789044739,0
2926301,Riachão do Jacuípe,15,Bacia do Jacuípe,34784,11,1,29,4,45,12,33,40,5,129.369825207,34.4986200552,94.8712051518,114.995400184,14.374425023
2926400,Riacho de Santana,2,Velho Chico,36439,9,1,22,0,32,10,22,31,1,87.8179972008,27.4431241253,60.3748730756,85.0736847883,2.7443124125
2926509,Ribeira do Amparo,17,Semiárido Nordeste II,15443,7,0,15,0,22,7,15,22,0,142.4593667034,45.3279803147,97.1313863887,142.4593667034,0
2926608,Ribeira do Pombal,17,Semiárido Nordeste II,54965,24,4,57,2,87,28,59,81,6,158.2825434367,50.9415082325,107.3410352042,147.3665059583,10.9160374784
2926657,Ribeirão do Largo,20,Sudoeste Baiano,7437,3,0,7,0,10,3,7,10,0,134.46282103,40.338846309,94.123974721,134.46282103,0
2926707,Rio de Contas,3,Chapada Diamantina,13712,3,0,12,0,15,3,12,15,0,109.3932322054,21.8786464411,87.5145857643,109.3932322054,0
2926806,Rio do Antônio,13,Sertão Produtivo,15804,3,0,8,1,12,3,9,11,1,75.9301442673,18.9825360668,56.9476082005,69.602632245,6.3275120223
2926905,Rio do Pires,12,Bacia do Paramirim,12130,5,0,8,0,13,5,8,13,0,107.1723000824,41.2201154163,65.9521846661,107.1723000824,0
2927002,Rio Real,18,Litoral Norte e Agreste Baiano,41767,14,0,27,0,41,14,27,41,0,98.1636219982,33.5192855604,64.6443364379,98.1636219982,0
2927101,Rodelas,24,Itaparica,9405,9,0,10,0,19,9,10,19,0,202.0202020202,95.6937799043,106.3264221159,202.0202020202,0
2927200,Ruy Barbosa,14,Piemonte do Paraguaçu,32009,17,1,29,0,47,18,29,46,1,146.833703021,56.2341841357,90.5995188853,143.7095816802,3.1241213409
2927309,Salinas da Margarida,21,Recôncavo,15772,7,0,19,0,26,7,19,26,0,164.8490996703,44.3824499112,120.4666497591,164.8490996703,0
2927408,Salvador,26,Metropolitano de Salvador,2953986,6786,1606,5375,610,14377,8392,5985,12161,2216,486.6983120435,284.0907167468,202.6075952967,411.6810303096,75.0172817339
2927507,Santa Bárbara,19,Portal do Sertão,21415,6,1,17,0,24,7,17,23,1,112.0709782862,32.6873686668,79.3836096194,107.401354191,4.6696240953
2927606,Santa Brígida,17,Semiárido Nordeste II,14976,2,0,15,0,17,2,15,17,0,113.514957265,13.3547008547,100.1602564103,113.514957265,0
2927705,Santa Cruz Cabrália,27,Costa do Descobrimento,28552,12,0,18,0,30,12,18,30,0,105.071448585,42.028579434,63.042869151,105.071448585,0
2927804,Santa Cruz da Vitória,8,Médio Sudoeste da Bahia,6698,5,0,7,0,12,5,7,12,0,179.1579575993,74.6491489997,104.5088085996,179.1579575993,0
2927903,Santa Inês,9,Vale do Jiquiriçá,11161,3,1,13,0,17,4,13,16,1,152.3161007078,35.8390825195,116.4770181883,143.356330078,8.9597706299
2928000,Santaluz,4,Sisal,38422,22,1,40,1,64,23,41,62,2,166.5712352298,59.8615376607,106.7096975691,161.3658841289,5.2053511009
2928059,Santa Luzia,5,Litoral Sul,13398,2,0,14,0,16,2,14,16,0,119.420809076,14.9276011345,104.4932079415,119.420809076,0
2928109,Santa Maria da Vitória,23,Bacia do Rio Corrente,41769,22,3,36,0,61,25,36,58,3,146.0413225119,59.8530010295,86.1883214824,138.8589623884,7.1823601235
2928208,Santana,23,Bacia do Rio Corrente,27492,12,0,12,0,24,12,12,24,0,87.2981230904,43.6490615452,43.6490615452,87.2981230904,0
2928307,Santanópolis,19,Portal do Sertão,9263,2,0,6,0,8,2,6,8,0,86.3651084962,21.591277124,64.7738313721,86.3651084962,0
2928406,Santa Rita de Cássia,11,Bacia do Rio Grande,29146,11,0,26,0,37,11,26,37,0,126.9470939409,37.7410279284,89.2060660125,126.9470939409,0
2928505,Santa Terezinha,14,Piemonte do Paraguaçu,10682,4,0,9,0,13,4,9,13,0,121.7000561693,37.446171129,84.2538850403,121.7000561693,0
2928604,Santo Amaro,21,Recôncavo,61961,40,6,44,0,90,46,44,84,6,145.2526589306,74.2402478979,71.0124110327,135.5691483352,9.6835105954
2928703,Santo Antônio de Jesus,21,Recôncavo,103342,106,34,103,41,284,140,144,209,75,274.815660622,135.4725087573,139.3431518647,202.2411023592,72.5745582629
2928802,Santo Estevão,19,Portal do Sertão,53898,15,2,31,0,48,17,31,46,2,89.0571078704,31.5410590374,57.516048833,85.3463950425,3.7107128279
2928901,São Desidério,11,Bacia do Rio Grande,33661,7,0,26,0,33,7,26,33,0,98.0363031401,20.795579454,77.2407236862,98.0363031401,0
2928950,São Domingos,4,Sisal,9404,8,0,7,0,15,8,7,15,0,159.5065929392,85.0701829009,74.4364100383,159.5065929392,0
2929008,São Félix,21,Recôncavo,15310,23,0,24,0,47,23,24,47,0,306.9888961463,150.2286087525,156.7602873939,306.9888961463,0
2929057,São Félix do Coribe,23,Bacia do Rio Corrente,15825,6,0,14,0,20,6,14,20,0,126.3823064771,37.9146919431,88.467614534,126.3823064771,0
2929107,São Felipe,21,Recôncavo,21964,9,1,16,0,26,10,16,25,1,118.375523584,45.5290475323,72.8464760517,113.8226188308,4.5529047532
2929206,São Francisco do Conde,26,Metropolitano de Salvador,40220,29,5,67,0,101,34,67,96,5,251.1188463451,84.5350571855,166.5837891596,238.6872202884,12.4316260567
2929255,São Gabriel,1,Irecê,19613,2,0,9,0,11,2,9,11,0,56.0852495794,10.1973181053,45.887931474,56.0852495794,0
2929305,São Gonçalo dos Campos,19,Portal do Sertão,38018,9,3,16,0,28,12,16,25,3,73.6493240044,31.5639960019,42.0853280025,65.7583250039,7.8909990005
2929354,São José da Vitória,5,Litoral Sul,6045,0,0,3,0,3,0,3,3,0,49.6277915633,0,49.6277915633,49.6277915633,0
2929370,São José do Jacuípe,15,Bacia do Jacuípe,10784,1,0,6,0,7,1,6,7,0,64.9109792285,9.2729970326,55.6379821958,64.9109792285,0
2929404,São Miguel das Matas,9,Vale do Jiquiriçá,12092,4,0,6,0,10,4,6,10,0,82.6993053258,33.0797221303,49.6195831955,82.6993053258,0
2929503,São Sebastião do Passé,26,Metropolitano de Salvador,45827,21,3,33,0,57,24,33,54,3,124.380823532,52.3708730661,72.0099504659,117.8344643987,6.5463591333
2929602,Sapeaçu,21,Recôncavo,18114,7,0,24,0,31,7,24,31,0,171.1383460307,38.6441426521,132.4942033786,171.1383460307,0
2929701,Sátiro Dias,18,Litoral Norte e Agreste Baiano,20429,6,0,15,0,21,6,15,21,0,102.7950462578,29.3700132165,73.4250330413,102.7950462578,0
2929750,Saubara,21,Recôncavo,12380,4,0,8,0,12,4,8,12,0,96.9305331179,32.310177706,64.620355412,96.9305331179,0
2929800,Saúde,16,Piemonte da Diamantina,13385,3,0,6,0,9,3,6,9,0,67.2394471423,22.4131490474,44.8262980949,67.2394471423,0
2929909,Seabra,3,Chapada Diamantina,45568,23,4,34,2,63,27,36,57,6,138.2549157303,59.2521067416,79.0028089888,125.0877808989,13.1671348315
2930006,Sebastião Laranjeiras,13,Sertão Produtivo,11696,4,0,12,0,16,4,12,16,0,136.7989056088,34.1997264022,102.5991792066,136.7989056088,0
2930105,Senhor do Bonfim,25,Piemonte Norte do Itapicuru,81218,29,19,32,4,84,48,36,61,23,103.4253490606,59.1001994632,44.3251495974,75.1065034844,28.3188455761
2930154,Serra do Ramalho,2,Velho Chico,32991,4,0,19,0,23,4,19,23,0,69.7159831469,12.1245188082,57.5914643388,69.7159831469,0
2930204,Sento Sé,10,Sertão do São Francisco,41891,8,0,18,0,26,8,18,26,0,62.0658375307,19.0971807787,42.968656752,62.0658375307,0
2930303,Serra Dourada,23,Bacia do Rio Corrente,18320,7,0,13,0,20,7,13,20,0,109.1703056769,38.2096069869,70.96069869,109.1703056769,0
2930402,Serra Preta,15,Bacia do Jacuípe,16036,5,0,14,0,19,5,14,19,0,118.4834123223,31.179845348,87.3035669743,118.4834123223,0
2930501,Serrinha,4,Sisal,83088,22,13,67,2,104,35,69,89,15,125.1684960524,42.1240130946,83.0444829578,107.1153475833,18.0531484691
2930600,Serrolândia,16,Piemonte da Diamantina,13832,3,0,8,0,11,3,8,11,0,79.5257374205,21.6888374783,57.8368999422,79.5257374205,0
2930709,Simões Filho,26,Metropolitano de Salvador,136050,72,5,72,3,152,77,75,144,8,111.723631018,56.5968393973,55.1267916207,105.8434399118,5.8801911062
2930758,Sítio do Mato,2,Velho Chico,13437,5,0,13,0,18,5,13,18,0,133.9584728734,37.2106869093,96.7477859641,133.9584728734,0
2930766,Sítio do Quinto,17,Semiárido Nordeste II,11283,3,0,8,1,12,3,9,11,1,106.3546929008,26.5886732252,79.7660196756,97.4918018258,8.8628910751
2930774,Sobradinho,10,Sertão do São Francisco,23713,12,0,13,0,25,12,13,25,0,105.4274026905,50.6051532914,54.8222493991,105.4274026905,0
2930808,Souto Soares,3,Chapada Diamantina,17503,1,0,7,0,8,1,7,8,0,45.7064503228,5.7133062904,39.9931440325,45.7064503228,0
2930907,Tabocas do Brejo Velho,23,Bacia do Rio Corrente,13057,3,0,11,0,14,3,11,14,0,107.2221796737,22.9761813587,84.2459983151,107.2221796737,0
2931004,Tanhaçu,13,Sertão Produtivo,21315,7,1,17,0,25,8,17,24,1,117.2882946282,37.532254281,79.7560403472,112.5967628431,4.6915317851
2931053,Tanque Novo,13,Sertão Produtivo,17884,6,0,12,0,18,6,12,18,0,100.6486244688,33.5495414896,67.0990829792,100.6486244688,0
2931103,Tanquinho,19,Portal do Sertão,8232,2,0,5,0,7,2,5,7,0,85.0340136054,24.2954324587,60.7385811467,85.0340136054,0
2931202,Taperoá,6,Baixo Sul,21462,9,0,12,0,21,9,12,21,0,97.8473581213,41.934582052,55.9127760693,97.8473581213,0
2931301,Tapiramutá,14,Piemonte do Paraguaçu,17845,7,0,5,0,12,7,5,12,0,67.2457270944,39.2266741384,28.019052956,67.2457270944,0
2931350,Teixeira de Freitas,7,Extremo Sul,161690,150,62,120,30,362,212,150,270,92,223.8852124436,131.1150967902,92.7701156534,166.9862081761,56.8990042674
2931400,Teodoro Sampaio,19,Portal do Sertão,7936,2,1,6,0,9,3,6,8,1,113.4072580645,37.8024193548,75.6048387097,100.8064516129,12.6008064516
2931509,Teofilândia,4,Sisal,23378,7,0,14,0,21,7,14,21,0,89.8280434597,29.9426811532,59.8853623064,89.8280434597,0
2931608,Teolândia,6,Baixo Sul,15357,6,0,16,0,22,6,16,22,0,143.2571465781,39.0701308849,104.1870156932,143.2571465781,0
2931707,Terra Nova,19,Portal do Sertão,13536,6,0,14,0,20,6,14,20,0,147.7541371158,44.3262411348,103.4278959811,147.7541371158,0
2931806,Tremedal,20,Sudoeste Baiano,17700,7,0,19,0,26,7,19,26,0,146.8926553672,39.5480225989,107.3446327684,146.8926553672,0
2931905,Tucano,4,Sisal,52540,18,0,38,0,56,18,38,56,0,106.5854586981,34.2596117244,72.3258469737,106.5854586981,0
2932002,Uauá,10,Sertão do São Francisco,25773,5,2,6,0,13,7,6,11,2,50.4403833469,27.1602064176,23.2801769293,42.6803243705,7.7600589764
2932101,Ubaíra,9,Vale do Jiquiriçá,20800,7,0,13,0,20,7,13,20,0,96.1538461538,33.6538461538,62.5,96.1538461538,0
2932200,Ubaitaba,5,Litoral Sul,20489,6,0,17,0,23,6,17,23,0,112.2553565328,29.284006052,82.9713504807,112.2553565328,0
2932309,Ubatã,22,Médio Rio de Contas,27527,5,0,15,0,20,5,15,20,0,72.6559378065,18.1639844516,54.4919533549,72.6559378065,0
2932408,Uibaí,1,Irecê,14474,4,0,7,0,11,4,7,11,0,75.9983418544,27.6357606743,48.36258118,75.9983418544,0
2932457,Umburanas,16,Piemonte da Diamantina,19522,4,0,8,0,12,4,8,12,0,61.4691117713,20.4897039238,40.9794078476,61.4691117713,0
2932507,Una,5,Litoral Sul,21331,13,0,30,0,43,13,30,43,0,201.58454831,60.9441657681,140.6403825418,201.58454831,0
2932606,Urandi,13,Sertão Produtivo,17356,8,1,12,0,21,9,12,20,1,120.9956211109,51.8552661904,69.1403549205,115.2339248675,5.7616962434
2932705,Uruçuca,5,Litoral Sul,21711,9,0,11,0,20,9,11,20,0,92.1192022477,41.4536410115,50.6655612362,92.1192022477,0
2932804,Utinga,3,Chapada Diamantina,19780,4,0,10,0,14,4,10,14,0,70.7785642063,20.2224469161,50.5561172902,70.7785642063,0
2932903,Valença,6,Baixo Sul,98749,36,14,56,7,113,50,63,92,21,114.4315385472,50.6334241359,63.7981144113,93.1655004101,21.2660381371
2933000,Valente,4,Sisal,28743,11,0,16,0,27,11,16,27,0,93.9359148314,38.2701875239,55.6657273075,93.9359148314,0
2933059,Várzea da Roça,15,Bacia do Jacuípe,14662,4,0,10,0,14,4,10,14,0,95.4849270222,27.2814077206,68.2035193016,95.4849270222,0
2933109,Várzea do Poço,15,Bacia do Jacuípe,9449,0,0,6,0,6,0,6,6,0,63.49878294,0,63.49878294,63.49878294,0
2933158,Várzea Nova,16,Piemonte da Diamantina,13454,2,0,9,0,11,2,9,11,0,81.7600713542,14.865467519,66.8946038353,81.7600713542,0
2933174,Varzedo,21,Recôncavo,9375,2,0,8,0,10,2,8,10,0,106.6666666667,21.3333333333,85.3333333333,106.6666666667,0
2933208,Vera Cruz,26,Metropolitano de Salvador,43640,12,0,41,0,53,12,41,53,0,121.4482126489,27.4977085243,93.9505041247,121.4482126489,0
2933257,Vereda,7,Extremo Sul,6620,4,0,8,0,12,4,8,12,0,181.2688821752,60.4229607251,120.8459214502,181.2688821752,0
2933307,Vitória da Conquista,20,Sudoeste Baiano,348718,495,177,367,50,1089,672,417,862,227,312.2867187814,192.7058540138,119.5808647675,247.191140119,65.0955786624
2933406,Wagner,3,Chapada Diamantina,9753,2,0,5,0,7,2,5,7,0,71.7727878601,20.5065108172,51.266277043,71.7727878601,0
2933455,Wanderley,11,Bacia do Rio Grande,12935,5,0,12,0,17,5,12,17,0,131.4263625821,38.6548125242,92.771550058,131.4263625821,0
2933505,Wenceslau Guimarães,6,Baixo Sul,22365,9,0,23,0,32,9,23,32,0,143.080706461,40.2414486922,102.8392577688,143.080706461,0
2933604,Xique-Xique,1,Irecê,48365,8,1,23,0,32,9,23,31,1,66.1635480203,18.6084978807,47.5550501396,64.0959371446,2.0676108756
