Código,Município,Código TI,Território de Identidade,QtMédicosSUS,QtMédicosNãoSUS,QtEnfermeirosSUS,QtEnfermeirosNãoSUS,QtProfissionais,QtMédicos,QtEnfermeiros,QtSUS,QtNãoSUS,LogQtMédicosSUS,LogQtMédicosNãoSUS,LogQtEnfermeirosSUS,LogQtEnfermeirosNãoSUS,LogQtProfissionais,LogQtMédicos,LogQtEnfermeiros,LogQtSUS,LogQtNãoSUS
2900108,Abaíra,3,Chapada Diamantina,4,0,7,0,11,4,7,11,0,"0,6020599913",-1,"0,84509804",-1,"1,0413926852","0,6020599913","0,84509804","1,0413926852",-1
2900207,Abaré,24,Itaparica,9,0,19,0,28,9,19,28,0,"0,9542425094",-1,"1,278753601",-1,"1,4471580313","0,9542425094","1,278753601","1,4471580313",-1
2900306,Acajutiba,18,Litoral Norte e Agreste Baiano,9,2,12,0,23,11,12,21,2,"0,9542425094","0,3010299957","1,079181246",-1,"1,361727836","1,0413926852","1,079181246","1,3222192947","0,3010299957"
2900355,Adustina,17,Semiárido Nordeste II,7,0,9,1,17,7,10,16,1,"0,84509804",-1,"0,9542425094",0,"1,2304489214","0,84509804",1,"1,2041199827",0
2900405,Água Fria,19,Portal do Sertão,8,0,15,0,23,8,15,23,0,"0,903089987",-1,"1,1760912591",-1,"1,361727836","0,903089987","1,1760912591","1,361727836",-1
2900504,Érico Cardoso,12,Bacia do Paramirim,6,0,13,0,19,6,13,19,0,"0,7781512504",-1,"1,1139433523",-1,"1,278753601","0,7781512504","1,1139433523","1,278753601",-1
2900603,Aiquara,22,Médio Rio de Contas,2,0,7,0,9,2,7,9,0,"0,3010299957",-1,"0,84509804",-1,"0,9542425094","0,3010299957","0,84509804","0,9542425094",-1
2900702,Alagoinhas,18,Litoral Norte e Agreste Baiano,171,121,179,24,495,292,203,350,145,"2,2329961104","2,0827853703","2,252853031","1,3802112417","2,6946051989","2,4653828514","2,3074960379","2,5440680444","2,1613680022"
2900801,Alcobaça,7,Extremo Sul,21,0,20,0,41,21,20,41,0,"1,3222192947",-1,"1,3010299957",-1,"1,6127838567","1,3222192947","1,3010299957","1,6127838567",-1
2900900,Almadina,5,Litoral Sul,5,0,5,0,10,5,5,10,0,"0,6989700043",-1,"0,6989700043",-1,1,"0,6989700043","0,6989700043",1,-1
2901007,Amargosa,9,Vale do Jiquiriçá,24,11,39,0,74,35,39,63,11,"1,3802112417","1,0413926852","1,591064607",-1,"1,8692317197","1,5440680444","1,591064607","1,7993405495","1,0413926852"
2901106,Amélia Rodrigues,19,Portal do Sertão,18,1,18,0,37,19,18,36,1,"1,2552725051",0,"1,2552725051",-1,"1,5682017241","1,278753601","1,2552725051","1,5563025008",0
2901155,América Dourada,1,Irecê,15,0,20,0,35,15,20,35,0,"1,1760912591",-1,"1,3010299957",-1,"1,5440680444","1,1760912591","1,3010299957","1,5440680444",-1
2901205,Anagé,20,Sudoeste Baiano,16,0,22,0,38,16,22,38,0,"1,2041199827",-1,"1,3424226808",-1,"1,5797835966","1,2041199827","1,3424226808","1,5797835966",-1
2901304,Andaraí,3,Chapada Diamantina,11,0,9,0,20,11,9,20,0,"1,0413926852",-1,"0,9542425094",-1,"1,3010299957","1,0413926852","0,9542425094","1,3010299957",-1
2901353,Andorinha,25,Piemonte Norte do Itapicuru,4,3,10,0,17,7,10,14,3,"0,6020599913","0,4771212547",1,-1,"1,2304489214","0,84509804",1,"1,1461280357","0,4771212547"
2901403,Angical,11,Bacia do Rio Grande,5,0,12,0,17,5,12,17,0,"0,6989700043",-1,"1,079181246",-1,"1,2304489214","0,6989700043","1,079181246","1,2304489214",-1
2901502,Anguera,19,Portal do Sertão,5,0,13,0,18,5,13,18,0,"0,6989700043",-1,"1,1139433523",-1,"1,2552725051","0,6989700043","1,1139433523","1,2552725051",-1
2901601,Antas,17,Semiárido Nordeste II,13,0,20,0,33,13,20,33,0,"1,1139433523",-1,"1,3010299957",-1,"1,5185139399","1,1139433523","1,3010299957","1,5185139399",-1
2901700,Antônio Cardoso,19,Portal do Sertão,4,0,11,0,15,4,11,15,0,"0,6020599913",-1,"1,0413926852",-1,"1,1760912591","0,6020599913","1,0413926852","1,1760912591",-1
2901809,Antônio Gonçalves,25,Piemonte Norte do Itapicuru,3,0,10,0,13,3,10,13,0,"0,4771212547",-1,1,-1,"1,1139433523","0,4771212547",1,"1,1139433523",-1
2901908,Aporá,18,Litoral Norte e Agreste Baiano,9,0,6,0,15,9,6,15,0,"0,9542425094",-1,"0,7781512504",-1,"1,1760912591","0,9542425094","0,7781512504","1,1760912591",-1
2901957,Apuarema,22,Médio Rio de Contas,5,0,7,0,12,5,7,12,0,"0,6989700043",-1,"0,84509804",-1,"1,079181246","0,6989700043","0,84509804","1,079181246",-1
2902005,Aracatu,20,Sudoeste Baiano,11,0,16,0,27,11,16,27,0,"1,0413926852",-1,"1,2041199827",-1,"1,4313637642","1,0413926852","1,2041199827","1,4313637642",-1
2902054,Araçás,18,Litoral Norte e Agreste Baiano,9,0,6,0,15,9,6,15,0,"0,9542425094",-1,"0,7781512504",-1,"1,1760912591","0,9542425094","0,7781512504","1,1760912591",-1
2902104,Araci,4,Sisal,20,2,42,0,64,22,42,62,2,"1,3010299957","0,3010299957","1,6232492904",-1,"1,806179974","1,3424226808","1,6232492904","1,7923916895","0,3010299957"
2902203,Aramari,18,Litoral Norte e Agreste Baiano,2,0,6,0,8,2,6,8,0,"0,3010299957",-1,"0,7781512504",-1,"0,903089987","0,3010299957","0,7781512504","0,903089987",-1
2902252,Arataca,5,Litoral Sul,5,0,10,0,15,5,10,15,0,"0,6989700043",-1,1,-1,"1,1760912591","0,6989700043",1,"1,1760912591",-1
2902302,Aratuípe,6,Baixo Sul,3,0,9,0,12,3,9,12,0,"0,4771212547",-1,"0,9542425094",-1,"1,079181246","0,4771212547","0,9542425094","1,079181246",-1
2902401,Aurelino Leal,5,Litoral Sul,8,0,10,0,18,8,10,18,0,"0,903089987",-1,1,-1,"1,2552725051","0,903089987",1,"1,2552725051",-1
2902500,Baianópolis,11,Bacia do Rio Grande,6,0,14,0,20,6,14,20,0,"0,7781512504",-1,"1,1461280357",-1,"1,3010299957","0,7781512504","1,1461280357","1,3010299957",-1
2902609,Baixa Grande,15,Bacia do Jacuípe,9,0,11,0,20,9,11,20,0,"0,9542425094",-1,"1,0413926852",-1,"1,3010299957","0,9542425094","1,0413926852","1,3010299957",-1
2902658,Banzaê,17,Semiárido Nordeste II,5,0,13,0,18,5,13,18,0,"0,6989700043",-1,"1,1139433523",-1,"1,2552725051","0,6989700043","1,1139433523","1,2552725051",-1
2902708,Barra,2,Velho Chico,28,0,40,0,68,28,40,68,0,"1,4471580313",-1,"1,6020599913",-1,"1,8325089127","1,4471580313","1,6020599913","1,8325089127",-1
2902807,Barra da Estiva,3,Chapada Diamantina,14,2,22,0,38,16,22,36,2,"1,1461280357","0,3010299957","1,3424226808",-1,"1,5797835966","1,2041199827","1,3424226808","1,5563025008","0,3010299957"
2902906,Barra do Choça,20,Sudoeste Baiano,24,1,21,0,46,25,21,45,1,"1,3802112417",0,"1,3222192947",-1,"1,6627578317","1,3979400087","1,3222192947","1,6532125138",0
2903003,Barra do Mendes,1,Irecê,4,0,17,0,21,4,17,21,0,"0,6020599913",-1,"1,2304489214",-1,"1,3222192947","0,6020599913","1,2304489214","1,3222192947",-1
2903102,Barra do Rocha,22,Médio Rio de Contas,1,0,4,0,5,1,4,5,0,0,-1,"0,6020599913",-1,"0,6989700043",0,"0,6020599913","0,6989700043",-1
2903201,Barreiras,11,Bacia do Rio Grande,201,84,266,5,556,285,271,467,89,"2,3031960574","1,9242792861","2,4248816366","0,6989700043","2,7450747916","2,45484486","2,4329692909","2,6693168806","1,9493900066"
2903235,Barro Alto,1,Irecê,6,0,7,0,13,6,7,13,0,"0,7781512504",-1,"0,84509804",-1,"1,1139433523","0,7781512504","0,84509804","1,1139433523",-1
2903276,Barrocas,4,Sisal,7,0,13,1,21,7,14,20,1,"0,84509804",-1,"1,1139433523",0,"1,3222192947","0,84509804","1,1461280357","1,3010299957",0
2903300,Barro Preto,5,Litoral Sul,5,0,7,0,12,5,7,12,0,"0,6989700043",-1,"0,84509804",-1,"1,079181246","0,6989700043","0,84509804","1,079181246",-1
2903409,Belmonte,27,Costa do Descobrimento,16,0,22,0,38,16,22,38,0,"1,2041199827",-1,"1,3424226808",-1,"1,5797835966","1,2041199827","1,3424226808","1,5797835966",-1
2903508,Belo Campo,20,Sudoeste Baiano,12,0,20,0,32,12,20,32,0,"1,079181246",-1,"1,3010299957",-1,"1,5051499783","1,079181246","1,3010299957","1,5051499783",-1
2903607,Biritinga,4,Sisal,9,0,16,0,25,9,16,25,0,"0,9542425094",-1,"1,2041199827",-1,"1,3979400087","0,9542425094","1,2041199827","1,3979400087",-1
2903706,Boa Nova,22,Médio Rio de Contas,4,0,10,0,14,4,10,14,0,"0,6020599913",-1,1,-1,"1,1461280357","0,6020599913",1,"1,1461280357",-1
2903805,Boa Vista do Tupim,14,Piemonte do Paraguaçu,11,0,11,0,22,11,11,22,0,"1,0413926852",-1,"1,0413926852",-1,"1,3424226808","1,0413926852","1,0413926852","1,3424226808",-1
2903904,Bom Jesus da Lapa,2,Velho Chico,63,8,80,0,151,71,80,143,8,"1,7993405495","0,903089987","1,903089987",-1,"2,1789769473","1,8512583487","1,903089987","2,1553360375","0,903089987"
2903953,Bom Jesus da Serra,20,Sudoeste Baiano,9,0,11,0,20,9,11,20,0,"0,9542425094",-1,"1,0413926852",-1,"1,3010299957","0,9542425094","1,0413926852","1,3010299957",-1
2904001,Boninal,3,Chapada Diamantina,3,0,7,0,10,3,7,10,0,"0,4771212547",-1,"0,84509804",-1,1,"0,4771212547","0,84509804",1,-1
2904050,Bonito,3,Chapada Diamantina,8,0,10,0,18,8,10,18,0,"0,903089987",-1,1,-1,"1,2552725051","0,903089987",1,"1,2552725051",-1
2904100,Boquira,12,Bacia do Paramirim,7,0,20,0,27,7,20,27,0,"0,84509804",-1,"1,3010299957",-1,"1,4313637642","0,84509804","1,3010299957","1,4313637642",-1
2904209,Botuporã,12,Bacia do Paramirim,7,0,11,0,18,7,11,18,0,"0,84509804",-1,"1,0413926852",-1,"1,2552725051","0,84509804","1,0413926852","1,2552725051",-1
2904308,Brejões,9,Vale do Jiquiriçá,5,0,7,0,12,5,7,12,0,"0,6989700043",-1,"0,84509804",-1,"1,079181246","0,6989700043","0,84509804","1,079181246",-1
2904407,Brejolândia,23,Bacia do Rio Corrente,2,0,7,0,9,2,7,9,0,"0,3010299957",-1,"0,84509804",-1,"0,9542425094","0,3010299957","0,84509804","0,9542425094",-1
2904506,Brotas de Macaúbas,2,Velho Chico,6,0,8,0,14,6,8,14,0,"0,7781512504",-1,"0,903089987",-1,"1,1461280357","0,7781512504","0,903089987","1,1461280357",-1
2904605,Brumado,13,Sertão Produtivo,76,28,75,4,183,104,79,151,32,"1,8808135923","1,4471580313","1,8750612634","0,6020599913","2,2624510897","2,0170333393","1,8976270913","2,1789769473","1,5051499783"
2904704,Buerarema,5,Litoral Sul,7,0,16,0,23,7,16,23,0,"0,84509804",-1,"1,2041199827",-1,"1,361727836","0,84509804","1,2041199827","1,361727836",-1
2904753,Buritirama,11,Bacia do Rio Grande,4,0,16,0,20,4,16,20,0,"0,6020599913",-1,"1,2041199827",-1,"1,3010299957","0,6020599913","1,2041199827","1,3010299957",-1
2904803,Caatiba,8,Médio Sudoeste da Bahia,3,0,6,0,9,3,6,9,0,"0,4771212547",-1,"0,7781512504",-1,"0,9542425094","0,4771212547","0,7781512504","0,9542425094",-1
2904852,Cabaceiras do Paraguaçu,21,Recôncavo,5,0,18,0,23,5,18,23,0,"0,6989700043",-1,"1,2552725051",-1,"1,361727836","0,6989700043","1,2552725051","1,361727836",-1
2904902,Cachoeira,21,Recôncavo,27,8,30,0,65,35,30,57,8,"1,4313637642","0,903089987","1,4771212547",-1,"1,8129133566","1,5440680444","1,4771212547","1,7558748557","0,903089987"
2905008,Caculé,13,Sertão Produtivo,11,19,22,1,53,30,23,33,20,"1,0413926852","1,278753601","1,3424226808",0,"1,7242758696","1,4771212547","1,361727836","1,5185139399","1,3010299957"
2905107,Caém,16,Piemonte da Diamantina,9,0,7,0,16,9,7,16,0,"0,9542425094",-1,"0,84509804",-1,"1,2041199827","0,9542425094","0,84509804","1,2041199827",-1
2905156,Caetanos,20,Sudoeste Baiano,6,0,11,0,17,6,11,17,0,"0,7781512504",-1,"1,0413926852",-1,"1,2304489214","0,7781512504","1,0413926852","1,2304489214",-1
2905206,Caetité,13,Sertão Produtivo,54,11,41,2,108,65,43,95,13,"1,7323937598","1,0413926852","1,6127838567","0,3010299957","2,0334237555","1,8129133566","1,6334684556","1,9777236053","1,1139433523"
2905305,Cafarnaum,1,Irecê,12,0,12,0,24,12,12,24,0,"1,079181246",-1,"1,079181246",-1,"1,3802112417","1,079181246","1,079181246","1,3802112417",-1
2905404,Cairu,6,Baixo Sul,11,0,11,0,22,11,11,22,0,"1,0413926852",-1,"1,0413926852",-1,"1,3424226808","1,0413926852","1,0413926852","1,3424226808",-1
2905503,Caldeirão Grande,25,Piemonte Norte do Itapicuru,6,0,8,0,14,6,8,14,0,"0,7781512504",-1,"0,903089987",-1,"1,1461280357","0,7781512504","0,903089987","1,1461280357",-1
2905602,Camacan,5,Litoral Sul,21,1,27,0,49,22,27,48,1,"1,3222192947",0,"1,4313637642",-1,"1,69019608","1,3424226808","1,4313637642","1,6812412374",0
2905701,Camaçari,26,Metropolitano de Salvador,431,145,279,29,884,576,308,710,174,"2,6344772702","2,1613680022","2,4456042033","1,4623979979","2,946452265","2,7604224834","2,4885507165","2,8512583487","2,2405492483"
2905800,Camamu,6,Baixo Sul,15,6,26,0,47,21,26,41,6,"1,1760912591","0,7781512504","1,414973348",-1,"1,6720978579","1,3222192947","1,414973348","1,6127838567","0,7781512504"
2905909,Campo Alegre de Lourdes,10,Sertão do São Francisco,8,0,17,1,26,8,18,25,1,"0,903089987",-1,"1,2304489214",0,"1,414973348","0,903089987","1,2552725051","1,3979400087",0
2906006,Campo Formoso,25,Piemonte Norte do Itapicuru,43,9,36,0,88,52,36,79,9,"1,6334684556","0,9542425094","1,5563025008",-1,"1,9444826722","1,7160033436","1,5563025008","1,8976270913","0,9542425094"
2906105,Canápolis,23,Bacia do Rio Corrente,5,0,8,0,13,5,8,13,0,"0,6989700043",-1,"0,903089987",-1,"1,1139433523","0,6989700043","0,903089987","1,1139433523",-1
2906204,Canarana,1,Irecê,12,0,16,0,28,12,16,28,0,"1,079181246",-1,"1,2041199827",-1,"1,4471580313","1,079181246","1,2041199827","1,4471580313",-1
2906303,Canavieiras,5,Litoral Sul,17,3,20,1,41,20,21,37,4,"1,2304489214","0,4771212547","1,3010299957",0,"1,6127838567","1,3010299957","1,3222192947","1,5682017241","0,6020599913"
2906402,Candeal,4,Sisal,7,0,8,0,15,7,8,15,0,"0,84509804",-1,"0,903089987",-1,"1,1760912591","0,84509804","0,903089987","1,1760912591",-1
2906501,Candeias,26,Metropolitano de Salvador,88,35,76,19,218,123,95,164,54,"1,9444826722","1,5440680444","1,8808135923","1,278753601","2,3384564936","2,0899051114","1,9777236053","2,214843848","1,7323937598"
2906600,Candiba,13,Sertão Produtivo,3,0,5,0,8,3,5,8,0,"0,4771212547",-1,"0,6989700043",-1,"0,903089987","0,4771212547","0,6989700043","0,903089987",-1
2906709,Cândido Sales,20,Sudoeste Baiano,8,0,21,0,29,8,21,29,0,"0,903089987",-1,"1,3222192947",-1,"1,4623979979","0,903089987","1,3222192947","1,4623979979",-1
2906808,Cansanção,4,Sisal,17,1,21,0,39,18,21,38,1,"1,2304489214",0,"1,3222192947",-1,"1,591064607","1,2552725051","1,3222192947","1,5797835966",0
2906824,Canudos,10,Sertão do São Francisco,8,0,12,0,20,8,12,20,0,"0,903089987",-1,"1,079181246",-1,"1,3010299957","0,903089987","1,079181246","1,3010299957",-1
2906857,Capela do Alto Alegre,15,Bacia do Jacuípe,10,0,12,0,22,10,12,22,0,1,-1,"1,079181246",-1,"1,3424226808",1,"1,079181246","1,3424226808",-1
2906873,Capim Grosso,15,Bacia do Jacuípe,18,3,30,0,51,21,30,48,3,"1,2552725051","0,4771212547","1,4771212547",-1,"1,7075701761","1,3222192947","1,4771212547","1,6812412374","0,4771212547"
2906899,Caraíbas,20,Sudoeste Baiano,3,0,12,0,15,3,12,15,0,"0,4771212547",-1,"1,079181246",-1,"1,1760912591","0,4771212547","1,079181246","1,1760912591",-1
2906907,Caravelas,7,Extremo Sul,11,0,20,0,31,11,20,31,0,"1,0413926852",-1,"1,3010299957",-1,"1,4913616938","1,0413926852","1,3010299957","1,4913616938",-1
2907004,Cardeal da Silva,18,Litoral Norte e Agreste Baiano,6,0,4,0,10,6,4,10,0,"0,7781512504",-1,"0,6020599913",-1,1,"0,7781512504","0,6020599913",1,-1
2907103,Carinhanha,2,Velho Chico,15,3,17,0,35,18,17,32,3,"1,1760912591","0,4771212547","1,2304489214",-1,"1,5440680444","1,2552725051","1,2304489214","1,5051499783","0,4771212547"
2907202,Casa Nova,10,Sertão do São Francisco,35,1,27,0,63,36,27,62,1,"1,5440680444",0,"1,4313637642",-1,"1,7993405495","1,5563025008","1,4313637642","1,7923916895",0
2907301,Castro Alves,21,Recôncavo,16,2,29,0,47,18,29,45,2,"1,2041199827","0,3010299957","1,4623979979",-1,"1,6720978579","1,2552725051","1,4623979979","1,6532125138","0,3010299957"
2907400,Catolândia,11,Bacia do Rio Grande,1,0,4,0,5,1,4,5,0,0,-1,"0,6020599913",-1,"0,6989700043",0,"0,6020599913","0,6989700043",-1
2907509,Catu,18,Litoral Norte e Agreste Baiano,26,27,34,11,98,53,45,60,38,"1,414973348","1,4313637642","1,531478917","1,0413926852","1,9912260757","1,7242758696","1,6532125138","1,7781512504","1,5797835966"
2907558,Caturama,12,Bacia do Paramirim,4,0,12,0,16,4,12,16,0,"0,6020599913",-1,"1,079181246",-1,"1,2041199827","0,6020599913","1,079181246","1,2041199827",-1
2907608,Central,1,Irecê,7,0,12,0,19,7,12,19,0,"0,84509804",-1,"1,079181246",-1,"1,278753601","0,84509804","1,079181246","1,278753601",-1
2907707,Chorrochó,24,Itaparica,5,0,15,0,20,5,15,20,0,"0,6989700043",-1,"1,1760912591",-1,"1,3010299957","0,6989700043","1,1760912591","1,3010299957",-1
2907806,Cícero Dantas,17,Semiárido Nordeste II,13,5,24,0,42,18,24,37,5,"1,1139433523","0,6989700043","1,3802112417",-1,"1,6232492904","1,2552725051","1,3802112417","1,5682017241","0,6989700043"
2907905,Cipó,17,Semiárido Nordeste II,8,0,15,0,23,8,15,23,0,"0,903089987",-1,"1,1760912591",-1,"1,361727836","0,903089987","1,1760912591","1,361727836",-1
2908002,Coaraci,5,Litoral Sul,12,2,23,0,37,14,23,35,2,"1,079181246","0,3010299957","1,361727836",-1,"1,5682017241","1,1461280357","1,361727836","1,5440680444","0,3010299957"
2908101,Cocos,23,Bacia do Rio Corrente,12,0,14,0,26,12,14,26,0,"1,079181246",-1,"1,1461280357",-1,"1,414973348","1,079181246","1,1461280357","1,414973348",-1
2908200,Conceição da Feira,19,Portal do Sertão,14,1,18,1,34,15,19,32,2,"1,1461280357",0,"1,2552725051",0,"1,531478917","1,1760912591","1,278753601","1,5051499783","0,3010299957"
2908309,Conceição do Almeida,21,Recôncavo,15,0,17,0,32,15,17,32,0,"1,1760912591",-1,"1,2304489214",-1,"1,5051499783","1,1760912591","1,2304489214","1,5051499783",-1
2908408,Conceição do Coité,4,Sisal,33,26,46,5,110,59,51,79,31,"1,5185139399","1,414973348","1,6627578317","0,6989700043","2,0413926852","1,7708520116","1,7075701761","1,8976270913","1,4913616938"
2908507,Conceição do Jacuípe,19,Portal do Sertão,39,12,28,1,80,51,29,67,13,"1,591064607","1,079181246","1,4471580313",0,"1,903089987","1,7075701761","1,4623979979","1,8260748027","1,1139433523"
2908606,Conde,18,Litoral Norte e Agreste Baiano,14,0,16,0,30,14,16,30,0,"1,1461280357",-1,"1,2041199827",-1,"1,4771212547","1,1461280357","1,2041199827","1,4771212547",-1
2908705,Condeúba,20,Sudoeste Baiano,10,3,26,0,39,13,26,36,3,1,"0,4771212547","1,414973348",-1,"1,591064607","1,1139433523","1,414973348","1,5563025008","0,4771212547"
2908804,Contendas do Sincorá,13,Sertão Produtivo,3,0,4,0,7,3,4,7,0,"0,4771212547",-1,"0,6020599913",-1,"0,84509804","0,4771212547","0,6020599913","0,84509804",-1
2908903,Coração de Maria,19,Portal do Sertão,13,0,20,0,33,13,20,33,0,"1,1139433523",-1,"1,3010299957",-1,"1,5185139399","1,1139433523","1,3010299957","1,5185139399",-1
2909000,Cordeiros,20,Sudoeste Baiano,8,0,11,0,19,8,11,19,0,"0,903089987",-1,"1,0413926852",-1,"1,278753601","0,903089987","1,0413926852","1,278753601",-1
2909109,Coribe,23,Bacia do Rio Corrente,13,0,21,0,34,13,21,34,0,"1,1139433523",-1,"1,3222192947",-1,"1,531478917","1,1139433523","1,3222192947","1,531478917",-1
2909208,Coronel João Sá,17,Semiárido Nordeste II,8,0,10,0,18,8,10,18,0,"0,903089987",-1,1,-1,"1,2552725051","0,903089987",1,"1,2552725051",-1
2909307,Correntina,23,Bacia do Rio Corrente,8,0,18,1,27,8,19,26,1,"0,903089987",-1,"1,2552725051",0,"1,4313637642","0,903089987","1,278753601","1,414973348",0
2909406,Cotegipe,11,Bacia do Rio Grande,4,0,10,0,14,4,10,14,0,"0,6020599913",-1,1,-1,"1,1461280357","0,6020599913",1,"1,1461280357",-1
2909505,Cravolândia,9,Vale do Jiquiriçá,3,0,5,0,8,3,5,8,0,"0,4771212547",-1,"0,6989700043",-1,"0,903089987","0,4771212547","0,6989700043","0,903089987",-1
2909604,Crisópolis,18,Litoral Norte e Agreste Baiano,14,0,18,0,32,14,18,32,0,"1,1461280357",-1,"1,2552725051",-1,"1,5051499783","1,1461280357","1,2552725051","1,5051499783",-1
2909703,Cristópolis,11,Bacia do Rio Grande,6,0,14,0,20,6,14,20,0,"0,7781512504",-1,"1,1461280357",-1,"1,3010299957","0,7781512504","1,1461280357","1,3010299957",-1
2909802,Cruz das Almas,21,Recôncavo,55,42,54,5,156,97,59,109,47,"1,7403626895","1,6232492904","1,7323937598","0,6989700043","2,1931245984","1,9867717343","1,7708520116","2,0374264979","1,6720978579"
2909901,Curaçá,10,Sertão do São Francisco,15,0,22,0,37,15,22,37,0,"1,1760912591",-1,"1,3424226808",-1,"1,5682017241","1,1760912591","1,3424226808","1,5682017241",-1
2910008,Dário Meira,22,Médio Rio de Contas,0,0,10,0,10,0,10,10,0,-1,-1,1,-1,1,-1,1,1,-1
2910057,Dias D'Ávila,26,Metropolitano de Salvador,38,23,53,4,118,61,57,91,27,"1,5797835966","1,361727836","1,7242758696","0,6020599913","2,0718820073","1,785329835","1,7558748557","1,9590413923","1,4313637642"
2910107,Dom Basílio,13,Sertão Produtivo,8,0,10,0,18,8,10,18,0,"0,903089987",-1,1,-1,"1,2552725051","0,903089987",1,"1,2552725051",-1
2910206,Dom Macedo Costa,21,Recôncavo,3,0,5,0,8,3,5,8,0,"0,4771212547",-1,"0,6989700043",-1,"0,903089987","0,4771212547","0,6989700043","0,903089987",-1
2910305,Elísio Medrado,9,Vale do Jiquiriçá,2,0,8,0,10,2,8,10,0,"0,3010299957",-1,"0,903089987",-1,1,"0,3010299957","0,903089987",1,-1
2910404,Encruzilhada,20,Sudoeste Baiano,12,0,14,0,26,12,14,26,0,"1,079181246",-1,"1,1461280357",-1,"1,414973348","1,079181246","1,1461280357","1,414973348",-1
2910503,Entre Rios,18,Litoral Norte e Agreste Baiano,22,4,28,0,54,26,28,50,4,"1,3424226808","0,6020599913","1,4471580313",-1,"1,7323937598","1,414973348","1,4471580313","1,6989700043","0,6020599913"
2910602,Esplanada,18,Litoral Norte e Agreste Baiano,11,2,26,0,39,13,26,37,2,"1,0413926852","0,3010299957","1,414973348",-1,"1,591064607","1,1139433523","1,414973348","1,5682017241","0,3010299957"
2910701,Euclides da Cunha,17,Semiárido Nordeste II,34,4,53,1,92,38,54,87,5,"1,531478917","0,6020599913","1,7242758696",0,"1,9637878273","1,5797835966","1,7323937598","1,9395192526","0,6989700043"
2910727,Eunápolis,27,Costa do Descobrimento,131,47,137,10,325,178,147,268,57,"2,1172712957","1,6720978579","2,1367205672",1,"2,511883361","2,2504200023","2,1673173347","2,428134794","1,7558748557"
2910750,Fátima,17,Semiárido Nordeste II,6,1,19,0,26,7,19,25,1,"0,7781512504",0,"1,278753601",-1,"1,414973348","0,84509804","1,278753601","1,3979400087",0
2910776,Feira da Mata,2,Velho Chico,3,0,5,0,8,3,5,8,0,"0,4771212547",-1,"0,6989700043",-1,"0,903089987","0,4771212547","0,6989700043","0,903089987",-1
2910800,Feira de Santana,19,Portal do Sertão,890,133,865,36,1924,1023,901,1755,169,"2,9493900066","2,123851641","2,9370161075","1,5563025008","3,2842050677","3,0098756337","2,954724791","3,2442771208","2,2278867046"
2910859,Filadélfia,25,Piemonte Norte do Itapicuru,12,0,14,0,26,12,14,26,0,"1,079181246",-1,"1,1461280357",-1,"1,414973348","1,079181246","1,1461280357","1,414973348",-1
2910909,Firmino Alves,8,Médio Sudoeste da Bahia,2,0,2,0,4,2,2,4,0,"0,3010299957",-1,"0,3010299957",-1,"0,6020599913","0,3010299957","0,3010299957","0,6020599913",-1
2911006,Floresta Azul,5,Litoral Sul,4,0,9,0,13,4,9,13,0,"0,6020599913",-1,"0,9542425094",-1,"1,1139433523","0,6020599913","0,9542425094","1,1139433523",-1
2911105,Formosa do Rio Preto,11,Bacia do Rio Grande,4,0,18,0,22,4,18,22,0,"0,6020599913",-1,"1,2552725051",-1,"1,3424226808","0,6020599913","1,2552725051","1,3424226808",-1
2911204,Gandu,6,Baixo Sul,15,20,24,1,60,35,25,39,21,"1,1760912591","1,3010299957","1,3802112417",0,"1,7781512504","1,5440680444","1,3979400087","1,591064607","1,3222192947"
2911253,Gavião,15,Bacia do Jacuípe,1,0,5,0,6,1,5,6,0,0,-1,"0,6989700043",-1,"0,7781512504",0,"0,6989700043","0,7781512504",-1
2911303,Gentio do Ouro,1,Irecê,4,0,7,0,11,4,7,11,0,"0,6020599913",-1,"0,84509804",-1,"1,0413926852","0,6020599913","0,84509804","1,0413926852",-1
2911402,Glória,24,Itaparica,8,0,6,0,14,8,6,14,0,"0,903089987",-1,"0,7781512504",-1,"1,1461280357","0,903089987","0,7781512504","1,1461280357",-1
2911501,Gongogi,22,Médio Rio de Contas,6,0,7,0,13,6,7,13,0,"0,7781512504",-1,"0,84509804",-1,"1,1139433523","0,7781512504","0,84509804","1,1139433523",-1
2911600,Governador Mangabeira,21,Recôncavo,12,1,14,2,29,13,16,26,3,"1,079181246",0,"1,1461280357","0,3010299957","1,4623979979","1,1139433523","1,2041199827","1,414973348","0,4771212547"
2911659,Guajeru,20,Sudoeste Baiano,7,0,8,0,15,7,8,15,0,"0,84509804",-1,"0,903089987",-1,"1,1760912591","0,84509804","0,903089987","1,1760912591",-1
2911709,Guanambi,13,Sertão Produtivo,155,22,174,3,354,177,177,329,25,"2,1903316982","1,3424226808","2,2405492483","0,4771212547","2,549003262","2,2479732664","2,2479732664","2,5171958979","1,3979400087"
2911808,Guaratinga,27,Costa do Descobrimento,6,0,20,0,26,6,20,26,0,"0,7781512504",-1,"1,3010299957",-1,"1,414973348","0,7781512504","1,3010299957","1,414973348",-1
2911857,Heliópolis,17,Semiárido Nordeste II,4,0,6,0,10,4,6,10,0,"0,6020599913",-1,"0,7781512504",-1,1,"0,6020599913","0,7781512504",1,-1
2911907,Iaçu,14,Piemonte do Paraguaçu,16,2,16,0,34,18,16,32,2,"1,2041199827","0,3010299957","1,2041199827",-1,"1,531478917","1,2552725051","1,2041199827","1,5051499783","0,3010299957"
2912004,Ibiassucê,13,Sertão Produtivo,4,0,13,0,17,4,13,17,0,"0,6020599913",-1,"1,1139433523",-1,"1,2304489214","0,6020599913","1,1139433523","1,2304489214",-1
2912103,Ibicaraí,5,Litoral Sul,12,0,26,0,38,12,26,38,0,"1,079181246",-1,"1,414973348",-1,"1,5797835966","1,079181246","1,414973348","1,5797835966",-1
2912202,Ibicoara,3,Chapada Diamantina,6,1,14,0,21,7,14,20,1,"0,7781512504",0,"1,1461280357",-1,"1,3222192947","0,84509804","1,1461280357","1,3010299957",0
2912301,Ibicuí,8,Médio Sudoeste da Bahia,6,3,19,0,28,9,19,25,3,"0,7781512504","0,4771212547","1,278753601",-1,"1,4471580313","0,9542425094","1,278753601","1,3979400087","0,4771212547"
2912400,Ibipeba,1,Irecê,4,1,13,2,20,5,15,17,3,"0,6020599913",0,"1,1139433523","0,3010299957","1,3010299957","0,6989700043","1,1760912591","1,2304489214","0,4771212547"
2912509,Ibipitanga,12,Bacia do Paramirim,4,1,12,0,17,5,12,16,1,"0,6020599913",0,"1,079181246",-1,"1,2304489214","0,6989700043","1,079181246","1,2041199827",0
2912608,Ibiquera,14,Piemonte do Paraguaçu,1,0,4,0,5,1,4,5,0,0,-1,"0,6020599913",-1,"0,6989700043",0,"0,6020599913","0,6989700043",-1
2912707,Ibirapitanga,6,Baixo Sul,9,0,13,0,22,9,13,22,0,"0,9542425094",-1,"1,1139433523",-1,"1,3424226808","0,9542425094","1,1139433523","1,3424226808",-1
2912806,Ibirapoã,7,Extremo Sul,6,0,6,0,12,6,6,12,0,"0,7781512504",-1,"0,7781512504",-1,"1,079181246","0,7781512504","0,7781512504","1,079181246",-1
2912905,Ibirataia,22,Médio Rio de Contas,9,0,13,0,22,9,13,22,0,"0,9542425094",-1,"1,1139433523",-1,"1,3424226808","0,9542425094","1,1139433523","1,3424226808",-1
2913002,Ibitiara,3,Chapada Diamantina,6,0,9,0,15,6,9,15,0,"0,7781512504",-1,"0,9542425094",-1,"1,1760912591","0,7781512504","0,9542425094","1,1760912591",-1
2913101,Ibititá,1,Irecê,6,1,10,0,17,7,10,16,1,"0,7781512504",0,1,-1,"1,2304489214","0,84509804",1,"1,2041199827",0
2913200,Ibotirama,2,Velho Chico,15,6,38,0,59,21,38,53,6,"1,1760912591","0,7781512504","1,5797835966",-1,"1,7708520116","1,3222192947","1,5797835966","1,7242758696","0,7781512504"
2913309,Ichu,4,Sisal,5,0,6,0,11,5,6,11,0,"0,6989700043",-1,"0,7781512504",-1,"1,0413926852","0,6989700043","0,7781512504","1,0413926852",-1
2913408,Igaporã,2,Velho Chico,4,0,16,0,20,4,16,20,0,"0,6020599913",-1,"1,2041199827",-1,"1,3010299957","0,6020599913","1,2041199827","1,3010299957",-1
2913457,Igrapiúna,6,Baixo Sul,8,0,15,0,23,8,15,23,0,"0,903089987",-1,"1,1760912591",-1,"1,361727836","0,903089987","1,1760912591","1,361727836",-1
2913507,Iguaí,8,Médio Sudoeste da Bahia,10,0,13,0,23,10,13,23,0,1,-1,"1,1139433523",-1,"1,361727836",1,"1,1139433523","1,361727836",-1
2913606,Ilhéus,5,Litoral Sul,198,71,229,13,511,269,242,427,84,"2,2966651903","1,8512583487","2,3598354823","1,1139433523","2,7084209001","2,42975228","2,383815366","2,630427875","1,9242792861"
2913705,Inhambupe,18,Litoral Norte e Agreste Baiano,18,0,26,0,44,18,26,44,0,"1,2552725051",-1,"1,414973348",-1,"1,6434526765","1,2552725051","1,414973348","1,6434526765",-1
2913804,Ipecaetá,19,Portal do Sertão,5,0,10,0,15,5,10,15,0,"0,6989700043",-1,1,-1,"1,1760912591","0,6989700043",1,"1,1760912591",-1
2913903,Ipiaú,22,Médio Rio de Contas,47,12,56,3,118,59,59,103,15,"1,6720978579","1,079181246","1,748188027","0,4771212547","2,0718820073","1,7708520116","1,7708520116","2,0128372247","1,1760912591"
2914000,Ipirá,15,Bacia do Jacuípe,17,5,31,2,55,22,33,48,7,"1,2304489214","0,6989700043","1,4913616938","0,3010299957","1,7403626895","1,3424226808","1,5185139399","1,6812412374","0,84509804"
2914109,Ipupiara,1,Irecê,3,0,10,0,13,3,10,13,0,"0,4771212547",-1,1,-1,"1,1139433523","0,4771212547",1,"1,1139433523",-1
2914208,Irajuba,9,Vale do Jiquiriçá,1,0,7,0,8,1,7,8,0,0,-1,"0,84509804",-1,"0,903089987",0,"0,84509804","0,903089987",-1
2914307,Iramaia,3,Chapada Diamantina,6,0,8,0,14,6,8,14,0,"0,7781512504",-1,"0,903089987",-1,"1,1461280357","0,7781512504","0,903089987","1,1461280357",-1
2914406,Iraquara,3,Chapada Diamantina,13,1,6,0,20,14,6,19,1,"1,1139433523",0,"0,7781512504",-1,"1,3010299957","1,1461280357","0,7781512504","1,278753601",0
2914505,Irará,19,Portal do Sertão,7,4,18,0,29,11,18,25,4,"0,84509804","0,6020599913","1,2552725051",-1,"1,4623979979","1,0413926852","1,2552725051","1,3979400087","0,6020599913"
2914604,Irecê,1,Irecê,141,10,117,2,270,151,119,258,12,"2,1492191127",1,"2,0681858617","0,3010299957","2,4313637642","2,1789769473","2,0755469614","2,411619706","1,079181246"
2914653,Itabela,27,Costa do Descobrimento,11,3,29,0,43,14,29,40,3,"1,0413926852","0,4771212547","1,4623979979",-1,"1,6334684556","1,1461280357","1,4623979979","1,6020599913","0,4771212547"
2914703,Itaberaba,14,Piemonte do Paraguaçu,29,14,50,3,96,43,53,79,17,"1,4623979979","1,1461280357","1,6989700043","0,4771212547","1,982271233","1,6334684556","1,7242758696","1,8976270913","1,2304489214"
2914802,Itabuna,5,Litoral Sul,364,46,353,26,789,410,379,717,72,"2,5611013836","1,6627578317","2,5477747054","1,414973348","2,8970770032","2,6127838567","2,57863921","2,8555191557","1,8573324964"
2914901,Itacaré,5,Litoral Sul,18,3,19,0,40,21,19,37,3,"1,2552725051","0,4771212547","1,278753601",-1,"1,6020599913","1,3222192947","1,278753601","1,5682017241","0,4771212547"
2915007,Itaetê,3,Chapada Diamantina,2,0,13,0,15,2,13,15,0,"0,3010299957",-1,"1,1139433523",-1,"1,1760912591","0,3010299957","1,1139433523","1,1760912591",-1
2915106,Itagi,22,Médio Rio de Contas,3,0,12,0,15,3,12,15,0,"0,4771212547",-1,"1,079181246",-1,"1,1760912591","0,4771212547","1,079181246","1,1760912591",-1
2915205,Itagibá,22,Médio Rio de Contas,6,0,12,0,18,6,12,18,0,"0,7781512504",-1,"1,079181246",-1,"1,2552725051","0,7781512504","1,079181246","1,2552725051",-1
2915304,Itagimirim,27,Costa do Descobrimento,3,0,4,0,7,3,4,7,0,"0,4771212547",-1,"0,6020599913",-1,"0,84509804","0,4771212547","0,6020599913","0,84509804",-1
2915353,Itaguaçu da Bahia,1,Irecê,6,0,10,0,16,6,10,16,0,"0,7781512504",-1,1,-1,"1,2041199827","0,7781512504",1,"1,2041199827",-1
2915403,Itaju do Colônia,5,Litoral Sul,3,0,7,0,10,3,7,10,0,"0,4771212547",-1,"0,84509804",-1,1,"0,4771212547","0,84509804",1,-1
2915502,Itajuípe,5,Litoral Sul,4,0,18,0,22,4,18,22,0,"0,6020599913",-1,"1,2552725051",-1,"1,3424226808","0,6020599913","1,2552725051","1,3424226808",-1
2915601,Itamaraju,7,Extremo Sul,39,8,64,4,115,47,68,103,12,"1,591064607","0,903089987","1,806179974","0,6020599913","2,0606978404","1,6720978579","1,8325089127","2,0128372247","1,079181246"
2915700,Itamari,22,Médio Rio de Contas,1,0,5,0,6,1,5,6,0,0,-1,"0,6989700043",-1,"0,7781512504",0,"0,6989700043","0,7781512504",-1
2915809,Itambé,8,Médio Sudoeste da Bahia,13,0,21,0,34,13,21,34,0,"1,1139433523",-1,"1,3222192947",-1,"1,531478917","1,1139433523","1,3222192947","1,531478917",-1
2915908,Itanagra,18,Litoral Norte e Agreste Baiano,4,0,7,0,11,4,7,11,0,"0,6020599913",-1,"0,84509804",-1,"1,0413926852","0,6020599913","0,84509804","1,0413926852",-1
2916005,Itanhém,7,Extremo Sul,10,2,16,0,28,12,16,26,2,1,"0,3010299957","1,2041199827",-1,"1,4471580313","1,079181246","1,2041199827","1,414973348","0,3010299957"
2916104,Itaparica,26,Metropolitano de Salvador,24,3,23,0,50,27,23,47,3,"1,3802112417","0,4771212547","1,361727836",-1,"1,6989700043","1,4313637642","1,361727836","1,6720978579","0,4771212547"
2916203,Itapé,5,Litoral Sul,2,0,13,0,15,2,13,15,0,"0,3010299957",-1,"1,1139433523",-1,"1,1760912591","0,3010299957","1,1139433523","1,1760912591",-1
2916302,Itapebi,27,Costa do Descobrimento,4,0,12,0,16,4,12,16,0,"0,6020599913",-1,"1,079181246",-1,"1,2041199827","0,6020599913","1,079181246","1,2041199827",-1
2916401,Itapetinga,8,Médio Sudoeste da Bahia,52,21,74,1,148,73,75,126,22,"1,7160033436","1,3222192947","1,8692317197",0,"2,1702617154","1,8633228601","1,8750612634","2,1003705451","1,3424226808"
2916500,Itapicuru,18,Litoral Norte e Agreste Baiano,21,0,27,0,48,21,27,48,0,"1,3222192947",-1,"1,4313637642",-1,"1,6812412374","1,3222192947","1,4313637642","1,6812412374",-1
2916609,Itapitanga,5,Litoral Sul,3,0,9,0,12,3,9,12,0,"0,4771212547",-1,"0,9542425094",-1,"1,079181246","0,4771212547","0,9542425094","1,079181246",-1
2916708,Itaquara,9,Vale do Jiquiriçá,3,0,9,0,12,3,9,12,0,"0,4771212547",-1,"0,9542425094",-1,"1,079181246","0,4771212547","0,9542425094","1,079181246",-1
2916807,Itarantim,8,Médio Sudoeste da Bahia,7,1,15,1,24,8,16,22,2,"0,84509804",0,"1,1760912591",0,"1,3802112417","0,903089987","1,2041199827","1,3424226808","0,3010299957"
2916856,Itatim,14,Piemonte do Paraguaçu,10,0,16,0,26,10,16,26,0,1,-1,"1,2041199827",-1,"1,414973348",1,"1,2041199827","1,414973348",-1
2916906,Itiruçu,9,Vale do Jiquiriçá,2,0,9,0,11,2,9,11,0,"0,3010299957",-1,"0,9542425094",-1,"1,0413926852","0,3010299957","0,9542425094","1,0413926852",-1
2917003,Itiúba,4,Sisal,10,1,9,0,20,11,9,19,1,1,0,"0,9542425094",-1,"1,3010299957","1,0413926852","0,9542425094","1,278753601",0
2917102,Itororó,8,Médio Sudoeste da Bahia,8,1,13,0,22,9,13,21,1,"0,903089987",0,"1,1139433523",-1,"1,3424226808","0,9542425094","1,1139433523","1,3222192947",0
2917201,Ituaçu,13,Sertão Produtivo,9,1,19,0,29,10,19,28,1,"0,9542425094",0,"1,278753601",-1,"1,4623979979",1,"1,278753601","1,4471580313",0
2917300,Ituberá,6,Baixo Sul,5,3,13,2,23,8,15,18,5,"0,6989700043","0,4771212547","1,1139433523","0,3010299957","1,361727836","0,903089987","1,1760912591","1,2552725051","0,6989700043"
2917334,Iuiu,13,Sertão Produtivo,5,0,8,0,13,5,8,13,0,"0,6989700043",-1,"0,903089987",-1,"1,1139433523","0,6989700043","0,903089987","1,1139433523",-1
2917359,Jaborandi,23,Bacia do Rio Corrente,3,0,11,0,14,3,11,14,0,"0,4771212547",-1,"1,0413926852",-1,"1,1461280357","0,4771212547","1,0413926852","1,1461280357",-1
2917409,Jacaraci,20,Sudoeste Baiano,5,0,16,0,21,5,16,21,0,"0,6989700043",-1,"1,2041199827",-1,"1,3222192947","0,6989700043","1,2041199827","1,3222192947",-1
2917508,Jacobina,16,Piemonte da Diamantina,50,39,70,6,165,89,76,120,45,"1,6989700043","1,591064607","1,84509804","0,7781512504","2,2174839442","1,9493900066","1,8808135923","2,079181246","1,6532125138"
2917607,Jaguaquara,9,Vale do Jiquiriçá,19,8,48,1,76,27,49,67,9,"1,278753601","0,903089987","1,6812412374",0,"1,8808135923","1,4313637642","1,69019608","1,8260748027","0,9542425094"
2917706,Jaguarari,25,Piemonte Norte do Itapicuru,15,1,9,3,28,16,12,24,4,"1,1760912591",0,"0,9542425094","0,4771212547","1,4471580313","1,2041199827","1,079181246","1,3802112417","0,6020599913"
2917805,Jaguaripe,6,Baixo Sul,6,0,9,0,15,6,9,15,0,"0,7781512504",-1,"0,9542425094",-1,"1,1760912591","0,7781512504","0,9542425094","1,1760912591",-1
2917904,Jandaíra,18,Litoral Norte e Agreste Baiano,3,0,3,0,6,3,3,6,0,"0,4771212547",-1,"0,4771212547",-1,"0,7781512504","0,4771212547","0,4771212547","0,7781512504",-1
2918001,Jequié,22,Médio Rio de Contas,180,52,308,13,553,232,321,488,65,"2,2552725051","1,7160033436","2,4885507165","1,1139433523","2,7427251313","2,3654879849","2,5065050324","2,688419822","1,8129133566"
2918100,Jeremoabo,17,Semiárido Nordeste II,14,1,44,1,60,15,45,58,2,"1,1461280357",0,"1,6434526765",0,"1,7781512504","1,1760912591","1,6532125138","1,7634279936","0,3010299957"
2918209,Jiquiriçá,9,Vale do Jiquiriçá,9,0,12,0,21,9,12,21,0,"0,9542425094",-1,"1,079181246",-1,"1,3222192947","0,9542425094","1,079181246","1,3222192947",-1
2918308,Jitaúna,22,Médio Rio de Contas,1,0,14,0,15,1,14,15,0,0,-1,"1,1461280357",-1,"1,1760912591",0,"1,1461280357","1,1760912591",-1
2918357,João Dourado,1,Irecê,3,0,10,0,13,3,10,13,0,"0,4771212547",-1,1,-1,"1,1139433523","0,4771212547",1,"1,1139433523",-1
2918407,Juazeiro,10,Sertão do São Francisco,339,142,293,2,776,481,295,632,144,"2,5301996982","2,1522883444","2,4668676204","0,3010299957","2,8898617213","2,6821450764","2,469822016","2,8007170783","2,1583624921"
2918456,Jucuruçu,7,Extremo Sul,4,0,9,0,13,4,9,13,0,"0,6020599913",-1,"0,9542425094",-1,"1,1139433523","0,6020599913","0,9542425094","1,1139433523",-1
2918506,Jussara,1,Irecê,4,0,12,0,16,4,12,16,0,"0,6020599913",-1,"1,079181246",-1,"1,2041199827","0,6020599913","1,079181246","1,2041199827",-1
2918555,Jussari,5,Litoral Sul,4,0,8,0,12,4,8,12,0,"0,6020599913",-1,"0,903089987",-1,"1,079181246","0,6020599913","0,903089987","1,079181246",-1
2918605,Jussiape,3,Chapada Diamantina,6,0,10,0,16,6,10,16,0,"0,7781512504",-1,1,-1,"1,2041199827","0,7781512504",1,"1,2041199827",-1
2918704,Lafayette Coutinho,9,Vale do Jiquiriçá,1,0,7,0,8,1,7,8,0,0,-1,"0,84509804",-1,"0,903089987",0,"0,84509804","0,903089987",-1
2918753,Lagoa Real,13,Sertão Produtivo,2,0,10,0,12,2,10,12,0,"0,3010299957",-1,1,-1,"1,079181246","0,3010299957",1,"1,079181246",-1
2918803,Laje,9,Vale do Jiquiriçá,13,1,22,0,36,14,22,35,1,"1,1139433523",0,"1,3424226808",-1,"1,5563025008","1,1461280357","1,3424226808","1,5440680444",0
2918902,Lajedão,7,Extremo Sul,2,0,12,0,14,2,12,14,0,"0,3010299957",-1,"1,079181246",-1,"1,1461280357","0,3010299957","1,079181246","1,1461280357",-1
2919009,Lajedinho,14,Piemonte do Paraguaçu,0,0,-,0,0,0,#VALOR!,#VALOR!,0,-1,-1,-1,-1,-1,-1,-1,-1,-1
2919058,Lajedo do Tabocal,9,Vale do Jiquiriçá,1,0,10,0,11,1,10,11,0,0,-1,1,-1,"1,0413926852",0,1,"1,0413926852",-1
2919108,Lamarão,4,Sisal,0,0,8,0,8,0,8,8,0,-1,-1,"0,903089987",-1,"0,903089987",-1,"0,903089987","0,903089987",-1
2919157,Lapão,1,Irecê,6,0,18,0,24,6,18,24,0,"0,7781512504",-1,"1,2552725051",-1,"1,3802112417","0,7781512504","1,2552725051","1,3802112417",-1
2919207,Lauro de Freitas,26,Metropolitano de Salvador,235,238,178,20,671,473,198,413,258,"2,3710678623","2,3765769571","2,2504200023","1,3010299957","2,8267225202","2,6748611407","2,2966651903","2,6159500517","2,411619706"
2919306,Lençóis,3,Chapada Diamantina,4,0,15,0,19,4,15,19,0,"0,6020599913",-1,"1,1760912591",-1,"1,278753601","0,6020599913","1,1760912591","1,278753601",-1
2919405,Licínio de Almeida,20,Sudoeste Baiano,3,0,11,0,14,3,11,14,0,"0,4771212547",-1,"1,0413926852",-1,"1,1461280357","0,4771212547","1,0413926852","1,1461280357",-1
2919504,Livramento de Nossa Senhora,13,Sertão Produtivo,13,8,50,5,76,21,55,63,13,"1,1139433523","0,903089987","1,6989700043","0,6989700043","1,8808135923","1,3222192947","1,7403626895","1,7993405495","1,1139433523"
2919553,Luís Eduardo Magalhães,11,Bacia do Rio Grande,48,16,59,2,125,64,61,107,18,"1,6812412374","1,2041199827","1,7708520116","0,3010299957","2,096910013","1,806179974","1,785329835","2,0293837777","1,2552725051"
2919603,Macajuba,14,Piemonte do Paraguaçu,5,0,6,0,11,5,6,11,0,"0,6989700043",-1,"0,7781512504",-1,"1,0413926852","0,6989700043","0,7781512504","1,0413926852",-1
2919702,Macarani,8,Médio Sudoeste da Bahia,7,0,17,0,24,7,17,24,0,"0,84509804",-1,"1,2304489214",-1,"1,3802112417","0,84509804","1,2304489214","1,3802112417",-1
2919801,Macaúbas,12,Bacia do Paramirim,22,0,46,0,68,22,46,68,0,"1,3424226808",-1,"1,6627578317",-1,"1,8325089127","1,3424226808","1,6627578317","1,8325089127",-1
2919900,Macururé,24,Itaparica,3,0,8,0,11,3,8,11,0,"0,4771212547",-1,"0,903089987",-1,"1,0413926852","0,4771212547","0,903089987","1,0413926852",-1
2919926,Madre de Deus,26,Metropolitano de Salvador,18,1,22,1,42,19,23,40,2,"1,2552725051",0,"1,3424226808",0,"1,6232492904","1,278753601","1,361727836","1,6020599913","0,3010299957"
2919959,Maetinga,20,Sudoeste Baiano,9,0,12,0,21,9,12,21,0,"0,9542425094",-1,"1,079181246",-1,"1,3222192947","0,9542425094","1,079181246","1,3222192947",-1
2920007,Maiquinique,8,Médio Sudoeste da Bahia,3,0,7,0,10,3,7,10,0,"0,4771212547",-1,"0,84509804",-1,1,"0,4771212547","0,84509804",1,-1
2920106,Mairi,15,Bacia do Jacuípe,12,1,28,0,41,13,28,40,1,"1,079181246",0,"1,4471580313",-1,"1,6127838567","1,1139433523","1,4471580313","1,6020599913",0
2920205,Malhada,2,Velho Chico,1,0,10,0,11,1,10,11,0,0,-1,1,-1,"1,0413926852",0,1,"1,0413926852",-1
2920304,Malhada de Pedras,13,Sertão Produtivo,2,0,6,0,8,2,6,8,0,"0,3010299957",-1,"0,7781512504",-1,"0,903089987","0,3010299957","0,7781512504","0,903089987",-1
2920403,Manoel Vitorino,22,Médio Rio de Contas,1,0,16,0,17,1,16,17,0,0,-1,"1,2041199827",-1,"1,2304489214",0,"1,2041199827","1,2304489214",-1
2920452,Mansidão,11,Bacia do Rio Grande,5,0,6,0,11,5,6,11,0,"0,6989700043",-1,"0,7781512504",-1,"1,0413926852","0,6989700043","0,7781512504","1,0413926852",-1
2920502,Maracás,9,Vale do Jiquiriçá,6,1,24,0,31,7,24,30,1,"0,7781512504",0,"1,3802112417",-1,"1,4913616938","0,84509804","1,3802112417","1,4771212547",0
2920601,Maragogipe,21,Recôncavo,13,0,22,0,35,13,22,35,0,"1,1139433523",-1,"1,3424226808",-1,"1,5440680444","1,1139433523","1,3424226808","1,5440680444",-1
2920700,Maraú,5,Litoral Sul,5,0,15,0,20,5,15,20,0,"0,6989700043",-1,"1,1760912591",-1,"1,3010299957","0,6989700043","1,1760912591","1,3010299957",-1
2920809,Marcionílio Souza,3,Chapada Diamantina,3,0,3,0,6,3,3,6,0,"0,4771212547",-1,"0,4771212547",-1,"0,7781512504","0,4771212547","0,4771212547","0,7781512504",-1
2920908,Mascote,5,Litoral Sul,3,0,14,0,17,3,14,17,0,"0,4771212547",-1,"1,1461280357",-1,"1,2304489214","0,4771212547","1,1461280357","1,2304489214",-1
2921005,Mata de São João,26,Metropolitano de Salvador,28,3,31,1,63,31,32,59,4,"1,4471580313","0,4771212547","1,4913616938",0,"1,7993405495","1,4913616938","1,5051499783","1,7708520116","0,6020599913"
2921054,Matina,2,Velho Chico,3,0,10,0,13,3,10,13,0,"0,4771212547",-1,1,-1,"1,1139433523","0,4771212547",1,"1,1139433523",-1
2921104,Medeiros Neto,7,Extremo Sul,17,0,20,0,37,17,20,37,0,"1,2304489214",-1,"1,3010299957",-1,"1,5682017241","1,2304489214","1,3010299957","1,5682017241",-1
2921203,Miguel Calmon,16,Piemonte da Diamantina,11,2,28,1,42,13,29,39,3,"1,0413926852","0,3010299957","1,4471580313",0,"1,6232492904","1,1139433523","1,4623979979","1,591064607","0,4771212547"
2921302,Milagres,9,Vale do Jiquiriçá,3,0,10,0,13,3,10,13,0,"0,4771212547",-1,1,-1,"1,1139433523","0,4771212547",1,"1,1139433523",-1
2921401,Mirangaba,16,Piemonte da Diamantina,6,0,9,0,15,6,9,15,0,"0,7781512504",-1,"0,9542425094",-1,"1,1760912591","0,7781512504","0,9542425094","1,1760912591",-1
2921450,Mirante,20,Sudoeste Baiano,4,1,7,0,12,5,7,11,1,"0,6020599913",0,"0,84509804",-1,"1,079181246","0,6989700043","0,84509804","1,0413926852",0
2921500,Monte Santo,4,Sisal,12,0,20,0,32,12,20,32,0,"1,079181246",-1,"1,3010299957",-1,"1,5051499783","1,079181246","1,3010299957","1,5051499783",-1
2921609,Morpará,2,Velho Chico,5,0,11,0,16,5,11,16,0,"0,6989700043",-1,"1,0413926852",-1,"1,2041199827","0,6989700043","1,0413926852","1,2041199827",-1
2921708,Morro do Chapéu,3,Chapada Diamantina,23,0,34,0,57,23,34,57,0,"1,361727836",-1,"1,531478917",-1,"1,7558748557","1,361727836","1,531478917","1,7558748557",-1
2921807,Mortugaba,20,Sudoeste Baiano,7,1,14,1,23,8,15,21,2,"0,84509804",0,"1,1461280357",0,"1,361727836","0,903089987","1,1760912591","1,3222192947","0,3010299957"
2921906,Mucugê,3,Chapada Diamantina,5,0,13,0,18,5,13,18,0,"0,6989700043",-1,"1,1139433523",-1,"1,2552725051","0,6989700043","1,1139433523","1,2552725051",-1
2922003,Mucuri,7,Extremo Sul,41,7,34,0,82,48,34,75,7,"1,6127838567","0,84509804","1,531478917",-1,"1,9138138524","1,6812412374","1,531478917","1,8750612634","0,84509804"
2922052,Mulungu do Morro,1,Irecê,4,0,8,0,12,4,8,12,0,"0,6020599913",-1,"0,903089987",-1,"1,079181246","0,6020599913","0,903089987","1,079181246",-1
2922102,Mundo Novo,14,Piemonte do Paraguaçu,6,0,9,0,15,6,9,15,0,"0,7781512504",-1,"0,9542425094",-1,"1,1760912591","0,7781512504","0,9542425094","1,1760912591",-1
2922201,Muniz Ferreira,21,Recôncavo,4,0,6,0,10,4,6,10,0,"0,6020599913",-1,"0,7781512504",-1,1,"0,6020599913","0,7781512504",1,-1
2922250,Muquém do São Francisco,2,Velho Chico,1,0,8,0,9,1,8,9,0,0,-1,"0,903089987",-1,"0,9542425094",0,"0,903089987","0,9542425094",-1
2922300,Muritiba,21,Recôncavo,10,3,29,0,42,13,29,39,3,1,"0,4771212547","1,4623979979",-1,"1,6232492904","1,1139433523","1,4623979979","1,591064607","0,4771212547"
2922409,Mutuípe,9,Vale do Jiquiriçá,8,6,17,0,31,14,17,25,6,"0,903089987","0,7781512504","1,2304489214",-1,"1,4913616938","1,1461280357","1,2304489214","1,3979400087","0,7781512504"
2922508,Nazaré,21,Recôncavo,18,3,34,1,56,21,35,52,4,"1,2552725051","0,4771212547","1,531478917",0,"1,748188027","1,3222192947","1,5440680444","1,7160033436","0,6020599913"
2922607,Nilo Peçanha,6,Baixo Sul,4,0,10,0,14,4,10,14,0,"0,6020599913",-1,1,-1,"1,1461280357","0,6020599913",1,"1,1461280357",-1
2922656,Nordestina,4,Sisal,6,0,11,0,17,6,11,17,0,"0,7781512504",-1,"1,0413926852",-1,"1,2304489214","0,7781512504","1,0413926852","1,2304489214",-1
2922706,Nova Canaã,8,Médio Sudoeste da Bahia,6,0,14,0,20,6,14,20,0,"0,7781512504",-1,"1,1461280357",-1,"1,3010299957","0,7781512504","1,1461280357","1,3010299957",-1
2922730,Nova Fátima,15,Bacia do Jacuípe,1,2,12,1,16,3,13,13,3,0,"0,3010299957","1,079181246",0,"1,2041199827","0,4771212547","1,1139433523","1,1139433523","0,4771212547"
2922755,Nova Ibiá,22,Médio Rio de Contas,1,0,8,0,9,1,8,9,0,0,-1,"0,903089987",-1,"0,9542425094",0,"0,903089987","0,9542425094",-1
2922805,Nova Itarana,9,Vale do Jiquiriçá,3,0,3,0,6,3,3,6,0,"0,4771212547",-1,"0,4771212547",-1,"0,7781512504","0,4771212547","0,4771212547","0,7781512504",-1
2922854,Nova Redenção,3,Chapada Diamantina,4,0,5,0,9,4,5,9,0,"0,6020599913",-1,"0,6989700043",-1,"0,9542425094","0,6020599913","0,6989700043","0,9542425094",-1
2922904,Nova Soure,17,Semiárido Nordeste II,8,1,20,0,29,9,20,28,1,"0,903089987",0,"1,3010299957",-1,"1,4623979979","0,9542425094","1,3010299957","1,4471580313",0
2923001,Nova Viçosa,7,Extremo Sul,21,1,27,0,49,22,27,48,1,"1,3222192947",0,"1,4313637642",-1,"1,69019608","1,3424226808","1,4313637642","1,6812412374",0
2923035,Novo Horizonte,3,Chapada Diamantina,4,0,7,0,11,4,7,11,0,"0,6020599913",-1,"0,84509804",-1,"1,0413926852","0,6020599913","0,84509804","1,0413926852",-1
2923050,Novo Triunfo,17,Semiárido Nordeste II,4,0,6,0,10,4,6,10,0,"0,6020599913",-1,"0,7781512504",-1,1,"0,6020599913","0,7781512504",1,-1
2923100,Olindina,18,Litoral Norte e Agreste Baiano,7,1,14,0,22,8,14,21,1,"0,84509804",0,"1,1461280357",-1,"1,3424226808","0,903089987","1,1461280357","1,3222192947",0
2923209,Oliveira dos Brejinhos,2,Velho Chico,7,0,12,0,19,7,12,19,0,"0,84509804",-1,"1,079181246",-1,"1,278753601","0,84509804","1,079181246","1,278753601",-1
2923308,Ouriçangas,18,Litoral Norte e Agreste Baiano,4,0,5,0,9,4,5,9,0,"0,6020599913",-1,"0,6989700043",-1,"0,9542425094","0,6020599913","0,6989700043","0,9542425094",-1
2923357,Ourolândia,16,Piemonte da Diamantina,5,2,10,1,18,7,11,15,3,"0,6989700043","0,3010299957",1,0,"1,2552725051","0,84509804","1,0413926852","1,1760912591","0,4771212547"
2923407,Palmas de Monte Alto,13,Sertão Produtivo,7,0,11,0,18,7,11,18,0,"0,84509804",-1,"1,0413926852",-1,"1,2552725051","0,84509804","1,0413926852","1,2552725051",-1
2923506,Palmeiras,3,Chapada Diamantina,5,0,6,1,12,5,7,11,1,"0,6989700043",-1,"0,7781512504",0,"1,079181246","0,6989700043","0,84509804","1,0413926852",0
2923605,Paramirim,12,Bacia do Paramirim,16,6,35,4,61,22,39,51,10,"1,2041199827","0,7781512504","1,5440680444","0,6020599913","1,785329835","1,3424226808","1,591064607","1,7075701761",1
2923704,Paratinga,2,Velho Chico,5,0,17,0,22,5,17,22,0,"0,6989700043",-1,"1,2304489214",-1,"1,3424226808","0,6989700043","1,2304489214","1,3424226808",-1
2923803,Paripiranga,17,Semiárido Nordeste II,10,3,19,0,32,13,19,29,3,1,"0,4771212547","1,278753601",-1,"1,5051499783","1,1139433523","1,278753601","1,4623979979","0,4771212547"
2923902,Pau-Brasil,5,Litoral Sul,4,0,12,0,16,4,12,16,0,"0,6020599913",-1,"1,079181246",-1,"1,2041199827","0,6020599913","1,079181246","1,2041199827",-1
2924009,Paulo Afonso,24,Itaparica,108,50,93,8,259,158,101,201,58,"2,0334237555","1,6989700043","1,9684829486","0,903089987","2,4132997641","2,198657087","2,0043213738","2,3031960574","1,7634279936"
2924058,Pé de Serra,15,Bacia do Jacuípe,7,1,14,0,22,8,14,21,1,"0,84509804",0,"1,1461280357",-1,"1,3424226808","0,903089987","1,1461280357","1,3222192947",0
2924108,Pedrão,18,Litoral Norte e Agreste Baiano,3,0,6,0,9,3,6,9,0,"0,4771212547",-1,"0,7781512504",-1,"0,9542425094","0,4771212547","0,7781512504","0,9542425094",-1
2924207,Pedro Alexandre,17,Semiárido Nordeste II,5,0,13,0,18,5,13,18,0,"0,6989700043",-1,"1,1139433523",-1,"1,2552725051","0,6989700043","1,1139433523","1,2552725051",-1
2924306,Piatã,3,Chapada Diamantina,5,1,14,0,20,6,14,19,1,"0,6989700043",0,"1,1461280357",-1,"1,3010299957","0,7781512504","1,1461280357","1,278753601",0
2924405,Pilão Arcado,10,Sertão do São Francisco,7,0,12,0,19,7,12,19,0,"0,84509804",-1,"1,079181246",-1,"1,278753601","0,84509804","1,079181246","1,278753601",-1
2924504,Pindaí,13,Sertão Produtivo,1,0,13,0,14,1,13,14,0,0,-1,"1,1139433523",-1,"1,1461280357",0,"1,1139433523","1,1461280357",-1
2924603,Pindobaçu,25,Piemonte Norte do Itapicuru,3,0,7,0,10,3,7,10,0,"0,4771212547",-1,"0,84509804",-1,1,"0,4771212547","0,84509804",1,-1
2924652,Pintadas,15,Bacia do Jacuípe,2,0,7,0,9,2,7,9,0,"0,3010299957",-1,"0,84509804",-1,"0,9542425094","0,3010299957","0,84509804","0,9542425094",-1
2924678,Piraí do Norte,6,Baixo Sul,0,0,7,0,7,0,7,7,0,-1,-1,"0,84509804",-1,"0,84509804",-1,"0,84509804","0,84509804",-1
2924702,Piripá,20,Sudoeste Baiano,3,0,17,0,20,3,17,20,0,"0,4771212547",-1,"1,2304489214",-1,"1,3010299957","0,4771212547","1,2304489214","1,3010299957",-1
2924801,Piritiba,14,Piemonte do Paraguaçu,7,0,13,0,20,7,13,20,0,"0,84509804",-1,"1,1139433523",-1,"1,3010299957","0,84509804","1,1139433523","1,3010299957",-1
2924900,Planaltino,9,Vale do Jiquiriçá,1,0,5,0,6,1,5,6,0,0,-1,"0,6989700043",-1,"0,7781512504",0,"0,6989700043","0,7781512504",-1
2925006,Planalto,20,Sudoeste Baiano,6,0,17,0,23,6,17,23,0,"0,7781512504",-1,"1,2304489214",-1,"1,361727836","0,7781512504","1,2304489214","1,361727836",-1
2925105,Poções,20,Sudoeste Baiano,16,8,36,0,60,24,36,52,8,"1,2041199827","0,903089987","1,5563025008",-1,"1,7781512504","1,3802112417","1,5563025008","1,7160033436","0,903089987"
2925204,Pojuca,26,Metropolitano de Salvador,29,3,40,0,72,32,40,69,3,"1,4623979979","0,4771212547","1,6020599913",-1,"1,8573324964","1,5051499783","1,6020599913","1,8388490907","0,4771212547"
2925253,Ponto Novo,25,Piemonte Norte do Itapicuru,3,0,5,0,8,3,5,8,0,"0,4771212547",-1,"0,6989700043",-1,"0,903089987","0,4771212547","0,6989700043","0,903089987",-1
2925303,Porto Seguro,27,Costa do Descobrimento,98,32,167,4,301,130,171,265,36,"1,9912260757","1,5051499783","2,2227164711","0,6020599913","2,4785664956","2,1139433523","2,2329961104","2,4232458739","1,5563025008"
2925402,Potiraguá,8,Médio Sudoeste da Bahia,3,0,9,0,12,3,9,12,0,"0,4771212547",-1,"0,9542425094",-1,"1,079181246","0,4771212547","0,9542425094","1,079181246",-1
2925501,Prado,7,Extremo Sul,16,1,29,0,46,17,29,45,1,"1,2041199827",0,"1,4623979979",-1,"1,6627578317","1,2304489214","1,4623979979","1,6532125138",0
2925600,Presidente Dutra,1,Irecê,1,0,16,0,17,1,16,17,0,0,-1,"1,2041199827",-1,"1,2304489214",0,"1,2041199827","1,2304489214",-1
2925709,Presidente Jânio Quadros,20,Sudoeste Baiano,5,0,14,1,20,5,15,19,1,"0,6989700043",-1,"1,1461280357",0,"1,3010299957","0,6989700043","1,1760912591","1,278753601",0
2925758,Presidente Tancredo Neves,6,Baixo Sul,11,4,19,1,35,15,20,30,5,"1,0413926852","0,6020599913","1,278753601",0,"1,5440680444","1,1760912591","1,3010299957","1,4771212547","0,6989700043"
2925808,Queimadas,4,Sisal,7,1,15,0,23,8,15,22,1,"0,84509804",0,"1,1760912591",-1,"1,361727836","0,903089987","1,1760912591","1,3424226808",0
2925907,Quijingue,4,Sisal,9,0,15,0,24,9,15,24,0,"0,9542425094",-1,"1,1760912591",-1,"1,3802112417","0,9542425094","1,1760912591","1,3802112417",-1
2925931,Quixabeira,15,Bacia do Jacuípe,1,0,7,0,8,1,7,8,0,0,-1,"0,84509804",-1,"0,903089987",0,"0,84509804","0,903089987",-1
2925956,Rafael Jambeiro,14,Piemonte do Paraguaçu,10,0,23,0,33,10,23,33,0,1,-1,"1,361727836",-1,"1,5185139399",1,"1,361727836","1,5185139399",-1
2926004,Remanso,10,Sertão do São Francisco,21,5,26,3,55,26,29,47,8,"1,3222192947","0,6989700043","1,414973348","0,4771212547","1,7403626895","1,414973348","1,4623979979","1,6720978579","0,903089987"
2926103,Retirolândia,4,Sisal,8,0,14,0,22,8,14,22,0,"0,903089987",-1,"1,1461280357",-1,"1,3424226808","0,903089987","1,1461280357","1,3424226808",-1
2926202,Riachão das Neves,11,Bacia do Rio Grande,4,0,16,0,20,4,16,20,0,"0,6020599913",-1,"1,2041199827",-1,"1,3010299957","0,6020599913","1,2041199827","1,3010299957",-1
2926301,Riachão do Jacuípe,15,Bacia do Jacuípe,11,1,29,4,45,12,33,40,5,"1,0413926852",0,"1,4623979979","0,6020599913","1,6532125138","1,079181246","1,5185139399","1,6020599913","0,6989700043"
2926400,Riacho de Santana,2,Velho Chico,9,1,22,0,32,10,22,31,1,"0,9542425094",0,"1,3424226808",-1,"1,5051499783",1,"1,3424226808","1,4913616938",0
2926509,Ribeira do Amparo,17,Semiárido Nordeste II,7,0,15,0,22,7,15,22,0,"0,84509804",-1,"1,1760912591",-1,"1,3424226808","0,84509804","1,1760912591","1,3424226808",-1
2926608,Ribeira do Pombal,17,Semiárido Nordeste II,24,4,57,2,87,28,59,81,6,"1,3802112417","0,6020599913","1,7558748557","0,3010299957","1,9395192526","1,4471580313","1,7708520116","1,9084850189","0,7781512504"
2926657,Ribeirão do Largo,20,Sudoeste Baiano,3,0,7,0,10,3,7,10,0,"0,4771212547",-1,"0,84509804",-1,1,"0,4771212547","0,84509804",1,-1
2926707,Rio de Contas,3,Chapada Diamantina,3,0,12,0,15,3,12,15,0,"0,4771212547",-1,"1,079181246",-1,"1,1760912591","0,4771212547","1,079181246","1,1760912591",-1
2926806,Rio do Antônio,13,Sertão Produtivo,3,0,8,1,12,3,9,11,1,"0,4771212547",-1,"0,903089987",0,"1,079181246","0,4771212547","0,9542425094","1,0413926852",0
2926905,Rio do Pires,12,Bacia do Paramirim,5,0,8,0,13,5,8,13,0,"0,6989700043",-1,"0,903089987",-1,"1,1139433523","0,6989700043","0,903089987","1,1139433523",-1
2927002,Rio Real,18,Litoral Norte e Agreste Baiano,14,0,27,0,41,14,27,41,0,"1,1461280357",-1,"1,4313637642",-1,"1,6127838567","1,1461280357","1,4313637642","1,6127838567",-1
2927101,Rodelas,24,Itaparica,9,0,10,0,19,9,10,19,0,"0,9542425094",-1,1,-1,"1,278753601","0,9542425094",1,"1,278753601",-1
2927200,Ruy Barbosa,14,Piemonte do Paraguaçu,17,1,29,0,47,18,29,46,1,"1,2304489214",0,"1,4623979979",-1,"1,6720978579","1,2552725051","1,4623979979","1,6627578317",0
2927309,Salinas da Margarida,21,Recôncavo,7,0,19,0,26,7,19,26,0,"0,84509804",-1,"1,278753601",-1,"1,414973348","0,84509804","1,278753601","1,414973348",-1
2927507,Santa Bárbara,19,Portal do Sertão,6,1,17,0,24,7,17,23,1,"0,7781512504",0,"1,2304489214",-1,"1,3802112417","0,84509804","1,2304489214","1,361727836",0
2927606,Santa Brígida,17,Semiárido Nordeste II,2,0,15,0,17,2,15,17,0,"0,3010299957",-1,"1,1760912591",-1,"1,2304489214","0,3010299957","1,1760912591","1,2304489214",-1
2927705,Santa Cruz Cabrália,27,Costa do Descobrimento,12,0,18,0,30,12,18,30,0,"1,079181246",-1,"1,2552725051",-1,"1,4771212547","1,079181246","1,2552725051","1,4771212547",-1
2927804,Santa Cruz da Vitória,8,Médio Sudoeste da Bahia,5,0,7,0,12,5,7,12,0,"0,6989700043",-1,"0,84509804",-1,"1,079181246","0,6989700043","0,84509804","1,079181246",-1
2927903,Santa Inês,9,Vale do Jiquiriçá,3,1,13,0,17,4,13,16,1,"0,4771212547",0,"1,1139433523",-1,"1,2304489214","0,6020599913","1,1139433523","1,2041199827",0
2928000,Santaluz,4,Sisal,22,1,40,1,64,23,41,62,2,"1,3424226808",0,"1,6020599913",0,"1,806179974","1,361727836","1,6127838567","1,7923916895","0,3010299957"
2928059,Santa Luzia,5,Litoral Sul,2,0,14,0,16,2,14,16,0,"0,3010299957",-1,"1,1461280357",-1,"1,2041199827","0,3010299957","1,1461280357","1,2041199827",-1
2928109,Santa Maria da Vitória,23,Bacia do Rio Corrente,22,3,36,0,61,25,36,58,3,"1,3424226808","0,4771212547","1,5563025008",-1,"1,785329835","1,3979400087","1,5563025008","1,7634279936","0,4771212547"
2928208,Santana,23,Bacia do Rio Corrente,12,0,12,0,24,12,12,24,0,"1,079181246",-1,"1,079181246",-1,"1,3802112417","1,079181246","1,079181246","1,3802112417",-1
2928307,Santanópolis,19,Portal do Sertão,2,0,6,0,8,2,6,8,0,"0,3010299957",-1,"0,7781512504",-1,"0,903089987","0,3010299957","0,7781512504","0,903089987",-1
2928406,Santa Rita de Cássia,11,Bacia do Rio Grande,11,0,26,0,37,11,26,37,0,"1,0413926852",-1,"1,414973348",-1,"1,5682017241","1,0413926852","1,414973348","1,5682017241",-1
2928505,Santa Terezinha,14,Piemonte do Paraguaçu,4,0,9,0,13,4,9,13,0,"0,6020599913",-1,"0,9542425094",-1,"1,1139433523","0,6020599913","0,9542425094","1,1139433523",-1
2928604,Santo Amaro,21,Recôncavo,40,6,44,0,90,46,44,84,6,"1,6020599913","0,7781512504","1,6434526765",-1,"1,9542425094","1,6627578317","1,6434526765","1,9242792861","0,7781512504"
2928703,Santo Antônio de Jesus,21,Recôncavo,106,34,103,41,284,140,144,209,75,"2,0253058653","1,531478917","2,0128372247","1,6127838567","2,45331834","2,1461280357","2,1583624921","2,3201462861","1,8750612634"
2928802,Santo Estevão,19,Portal do Sertão,15,2,31,0,48,17,31,46,2,"1,1760912591","0,3010299957","1,4913616938",-1,"1,6812412374","1,2304489214","1,4913616938","1,6627578317","0,3010299957"
2928901,São Desidério,11,Bacia do Rio Grande,7,0,26,0,33,7,26,33,0,"0,84509804",-1,"1,414973348",-1,"1,5185139399","0,84509804","1,414973348","1,5185139399",-1
2928950,São Domingos,4,Sisal,8,0,7,0,15,8,7,15,0,"0,903089987",-1,"0,84509804",-1,"1,1760912591","0,903089987","0,84509804","1,1760912591",-1
2929008,São Félix,21,Recôncavo,23,0,24,0,47,23,24,47,0,"1,361727836",-1,"1,3802112417",-1,"1,6720978579","1,361727836","1,3802112417","1,6720978579",-1
2929057,São Félix do Coribe,23,Bacia do Rio Corrente,6,0,14,0,20,6,14,20,0,"0,7781512504",-1,"1,1461280357",-1,"1,3010299957","0,7781512504","1,1461280357","1,3010299957",-1
2929107,São Felipe,21,Recôncavo,9,1,16,0,26,10,16,25,1,"0,9542425094",0,"1,2041199827",-1,"1,414973348",1,"1,2041199827","1,3979400087",0
2929206,São Francisco do Conde,26,Metropolitano de Salvador,29,5,67,0,101,34,67,96,5,"1,4623979979","0,6989700043","1,8260748027",-1,"2,0043213738","1,531478917","1,8260748027","1,982271233","0,6989700043"
2929255,São Gabriel,1,Irecê,2,0,9,0,11,2,9,11,0,"0,3010299957",-1,"0,9542425094",-1,"1,0413926852","0,3010299957","0,9542425094","1,0413926852",-1
2929305,São Gonçalo dos Campos,19,Portal do Sertão,9,3,16,0,28,12,16,25,3,"0,9542425094","0,4771212547","1,2041199827",-1,"1,4471580313","1,079181246","1,2041199827","1,3979400087","0,4771212547"
2929354,São José da Vitória,5,Litoral Sul,0,0,3,0,3,0,3,3,0,-1,-1,"0,4771212547",-1,"0,4771212547",-1,"0,4771212547","0,4771212547",-1
2929370,São José do Jacuípe,15,Bacia do Jacuípe,1,0,6,0,7,1,6,7,0,0,-1,"0,7781512504",-1,"0,84509804",0,"0,7781512504","0,84509804",-1
2929404,São Miguel das Matas,9,Vale do Jiquiriçá,4,0,6,0,10,4,6,10,0,"0,6020599913",-1,"0,7781512504",-1,1,"0,6020599913","0,7781512504",1,-1
2929503,São Sebastião do Passé,26,Metropolitano de Salvador,21,3,33,0,57,24,33,54,3,"1,3222192947","0,4771212547","1,5185139399",-1,"1,7558748557","1,3802112417","1,5185139399","1,7323937598","0,4771212547"
2929602,Sapeaçu,21,Recôncavo,7,0,24,0,31,7,24,31,0,"0,84509804",-1,"1,3802112417",-1,"1,4913616938","0,84509804","1,3802112417","1,4913616938",-1
2929701,Sátiro Dias,18,Litoral Norte e Agreste Baiano,6,0,15,0,21,6,15,21,0,"0,7781512504",-1,"1,1760912591",-1,"1,3222192947","0,7781512504","1,1760912591","1,3222192947",-1
2929750,Saubara,21,Recôncavo,4,0,8,0,12,4,8,12,0,"0,6020599913",-1,"0,903089987",-1,"1,079181246","0,6020599913","0,903089987","1,079181246",-1
2929800,Saúde,16,Piemonte da Diamantina,3,0,6,0,9,3,6,9,0,"0,4771212547",-1,"0,7781512504",-1,"0,9542425094","0,4771212547","0,7781512504","0,9542425094",-1
2929909,Seabra,3,Chapada Diamantina,23,4,34,2,63,27,36,57,6,"1,361727836","0,6020599913","1,531478917","0,3010299957","1,7993405495","1,4313637642","1,5563025008","1,7558748557","0,7781512504"
2930006,Sebastião Laranjeiras,13,Sertão Produtivo,4,0,12,0,16,4,12,16,0,"0,6020599913",-1,"1,079181246",-1,"1,2041199827","0,6020599913","1,079181246","1,2041199827",-1
2930105,Senhor do Bonfim,25,Piemonte Norte do Itapicuru,29,19,32,4,84,48,36,61,23,"1,4623979979","1,278753601","1,5051499783","0,6020599913","1,9242792861","1,6812412374","1,5563025008","1,785329835","1,361727836"
2930154,Serra do Ramalho,2,Velho Chico,4,0,19,0,23,4,19,23,0,"0,6020599913",-1,"1,278753601",-1,"1,361727836","0,6020599913","1,278753601","1,361727836",-1
2930204,Sento Sé,10,Sertão do São Francisco,8,0,18,0,26,8,18,26,0,"0,903089987",-1,"1,2552725051",-1,"1,414973348","0,903089987","1,2552725051","1,414973348",-1
2930303,Serra Dourada,23,Bacia do Rio Corrente,7,0,13,0,20,7,13,20,0,"0,84509804",-1,"1,1139433523",-1,"1,3010299957","0,84509804","1,1139433523","1,3010299957",-1
2930402,Serra Preta,15,Bacia do Jacuípe,5,0,14,0,19,5,14,19,0,"0,6989700043",-1,"1,1461280357",-1,"1,278753601","0,6989700043","1,1461280357","1,278753601",-1
2930501,Serrinha,4,Sisal,22,13,67,2,104,35,69,89,15,"1,3424226808","1,1139433523","1,8260748027","0,3010299957","2,0170333393","1,5440680444","1,8388490907","1,9493900066","1,1760912591"
2930600,Serrolândia,16,Piemonte da Diamantina,3,0,8,0,11,3,8,11,0,"0,4771212547",-1,"0,903089987",-1,"1,0413926852","0,4771212547","0,903089987","1,0413926852",-1
2930709,Simões Filho,26,Metropolitano de Salvador,72,5,72,3,152,77,75,144,8,"1,8573324964","0,6989700043","1,8573324964","0,4771212547","2,1818435879","1,8864907252","1,8750612634","2,1583624921","0,903089987"
2930758,Sítio do Mato,2,Velho Chico,5,0,13,0,18,5,13,18,0,"0,6989700043",-1,"1,1139433523",-1,"1,2552725051","0,6989700043","1,1139433523","1,2552725051",-1
2930766,Sítio do Quinto,17,Semiárido Nordeste II,3,0,8,1,12,3,9,11,1,"0,4771212547",-1,"0,903089987",0,"1,079181246","0,4771212547","0,9542425094","1,0413926852",0
2930774,Sobradinho,10,Sertão do São Francisco,12,0,13,0,25,12,13,25,0,"1,079181246",-1,"1,1139433523",-1,"1,3979400087","1,079181246","1,1139433523","1,3979400087",-1
2930808,Souto Soares,3,Chapada Diamantina,1,0,7,0,8,1,7,8,0,0,-1,"0,84509804",-1,"0,903089987",0,"0,84509804","0,903089987",-1
2930907,Tabocas do Brejo Velho,23,Bacia do Rio Corrente,3,0,11,0,14,3,11,14,0,"0,4771212547",-1,"1,0413926852",-1,"1,1461280357","0,4771212547","1,0413926852","1,1461280357",-1
2931004,Tanhaçu,13,Sertão Produtivo,7,1,17,0,25,8,17,24,1,"0,84509804",0,"1,2304489214",-1,"1,3979400087","0,903089987","1,2304489214","1,3802112417",0
2931053,Tanque Novo,13,Sertão Produtivo,6,0,12,0,18,6,12,18,0,"0,7781512504",-1,"1,079181246",-1,"1,2552725051","0,7781512504","1,079181246","1,2552725051",-1
2931103,Tanquinho,19,Portal do Sertão,2,0,5,0,7,2,5,7,0,"0,3010299957",-1,"0,6989700043",-1,"0,84509804","0,3010299957","0,6989700043","0,84509804",-1
2931202,Taperoá,6,Baixo Sul,9,0,12,0,21,9,12,21,0,"0,9542425094",-1,"1,079181246",-1,"1,3222192947","0,9542425094","1,079181246","1,3222192947",-1
2931301,Tapiramutá,14,Piemonte do Paraguaçu,7,0,5,0,12,7,5,12,0,"0,84509804",-1,"0,6989700043",-1,"1,079181246","0,84509804","0,6989700043","1,079181246",-1
2931350,Teixeira de Freitas,7,Extremo Sul,150,62,120,30,362,212,150,270,92,"2,1760912591","1,7923916895","2,079181246","1,4771212547","2,5587085705","2,3263358609","2,1760912591","2,4313637642","1,9637878273"
2931400,Teodoro Sampaio,19,Portal do Sertão,2,1,6,0,9,3,6,8,1,"0,3010299957",0,"0,7781512504",-1,"0,9542425094","0,4771212547","0,7781512504","0,903089987",0
2931509,Teofilândia,4,Sisal,7,0,14,0,21,7,14,21,0,"0,84509804",-1,"1,1461280357",-1,"1,3222192947","0,84509804","1,1461280357","1,3222192947",-1
2931608,Teolândia,6,Baixo Sul,6,0,16,0,22,6,16,22,0,"0,7781512504",-1,"1,2041199827",-1,"1,3424226808","0,7781512504","1,2041199827","1,3424226808",-1
2931707,Terra Nova,19,Portal do Sertão,6,0,14,0,20,6,14,20,0,"0,7781512504",-1,"1,1461280357",-1,"1,3010299957","0,7781512504","1,1461280357","1,3010299957",-1
2931806,Tremedal,20,Sudoeste Baiano,7,0,19,0,26,7,19,26,0,"0,84509804",-1,"1,278753601",-1,"1,414973348","0,84509804","1,278753601","1,414973348",-1
2931905,Tucano,4,Sisal,18,0,38,0,56,18,38,56,0,"1,2552725051",-1,"1,5797835966",-1,"1,748188027","1,2552725051","1,5797835966","1,748188027",-1
2932002,Uauá,10,Sertão do São Francisco,5,2,6,0,13,7,6,11,2,"0,6989700043","0,3010299957","0,7781512504",-1,"1,1139433523","0,84509804","0,7781512504","1,0413926852","0,3010299957"
2932101,Ubaíra,9,Vale do Jiquiriçá,7,0,13,0,20,7,13,20,0,"0,84509804",-1,"1,1139433523",-1,"1,3010299957","0,84509804","1,1139433523","1,3010299957",-1
2932200,Ubaitaba,5,Litoral Sul,6,0,17,0,23,6,17,23,0,"0,7781512504",-1,"1,2304489214",-1,"1,361727836","0,7781512504","1,2304489214","1,361727836",-1
2932309,Ubatã,22,Médio Rio de Contas,5,0,15,0,20,5,15,20,0,"0,6989700043",-1,"1,1760912591",-1,"1,3010299957","0,6989700043","1,1760912591","1,3010299957",-1
2932408,Uibaí,1,Irecê,4,0,7,0,11,4,7,11,0,"0,6020599913",-1,"0,84509804",-1,"1,0413926852","0,6020599913","0,84509804","1,0413926852",-1
2932457,Umburanas,16,Piemonte da Diamantina,4,0,8,0,12,4,8,12,0,"0,6020599913",-1,"0,903089987",-1,"1,079181246","0,6020599913","0,903089987","1,079181246",-1
2932507,Una,5,Litoral Sul,13,0,30,0,43,13,30,43,0,"1,1139433523",-1,"1,4771212547",-1,"1,6334684556","1,1139433523","1,4771212547","1,6334684556",-1
2932606,Urandi,13,Sertão Produtivo,8,1,12,0,21,9,12,20,1,"0,903089987",0,"1,079181246",-1,"1,3222192947","0,9542425094","1,079181246","1,3010299957",0
2932705,Uruçuca,5,Litoral Sul,9,0,11,0,20,9,11,20,0,"0,9542425094",-1,"1,0413926852",-1,"1,3010299957","0,9542425094","1,0413926852","1,3010299957",-1
2932804,Utinga,3,Chapada Diamantina,4,0,10,0,14,4,10,14,0,"0,6020599913",-1,1,-1,"1,1461280357","0,6020599913",1,"1,1461280357",-1
2932903,Valença,6,Baixo Sul,36,14,56,7,113,50,63,92,21,"1,5563025008","1,1461280357","1,748188027","0,84509804","2,0530784435","1,6989700043","1,7993405495","1,9637878273","1,3222192947"
2933000,Valente,4,Sisal,11,0,16,0,27,11,16,27,0,"1,0413926852",-1,"1,2041199827",-1,"1,4313637642","1,0413926852","1,2041199827","1,4313637642",-1
2933059,Várzea da Roça,15,Bacia do Jacuípe,4,0,10,0,14,4,10,14,0,"0,6020599913",-1,1,-1,"1,1461280357","0,6020599913",1,"1,1461280357",-1
2933109,Várzea do Poço,15,Bacia do Jacuípe,0,0,6,0,6,0,6,6,0,-1,-1,"0,7781512504",-1,"0,7781512504",-1,"0,7781512504","0,7781512504",-1
2933158,Várzea Nova,16,Piemonte da Diamantina,2,0,9,0,11,2,9,11,0,"0,3010299957",-1,"0,9542425094",-1,"1,0413926852","0,3010299957","0,9542425094","1,0413926852",-1
2933174,Varzedo,21,Recôncavo,2,0,8,0,10,2,8,10,0,"0,3010299957",-1,"0,903089987",-1,1,"0,3010299957","0,903089987",1,-1
2933208,Vera Cruz,26,Metropolitano de Salvador,12,0,41,0,53,12,41,53,0,"1,079181246",-1,"1,6127838567",-1,"1,7242758696","1,079181246","1,6127838567","1,7242758696",-1
2933257,Vereda,7,Extremo Sul,4,0,8,0,12,4,8,12,0,"0,6020599913",-1,"0,903089987",-1,"1,079181246","0,6020599913","0,903089987","1,079181246",-1
2933307,Vitória da Conquista,20,Sudoeste Baiano,495,177,367,50,1089,672,417,862,227,"2,6946051989","2,2479732664","2,5646660643","1,6989700043","3,0370278798","2,8273692731","2,620136055","2,9355072658","2,3560258572"
2933406,Wagner,3,Chapada Diamantina,2,0,5,0,7,2,5,7,0,"0,3010299957",-1,"0,6989700043",-1,"0,84509804","0,3010299957","0,6989700043","0,84509804",-1
2933455,Wanderley,11,Bacia do Rio Grande,5,0,12,0,17,5,12,17,0,"0,6989700043",-1,"1,079181246",-1,"1,2304489214","0,6989700043","1,079181246","1,2304489214",-1
2933505,Wenceslau Guimarães,6,Baixo Sul,9,0,23,0,32,9,23,32,0,"0,9542425094",-1,"1,361727836",-1,"1,5051499783","0,9542425094","1,361727836","1,5051499783",-1
2933604,Xique-Xique,1,Irecê,8,1,23,0,32,9,23,31,1,"0,903089987",0,"1,361727836",-1,"1,5051499783","0,9542425094","1,361727836","1,4913616938",0
